"ym_quarter","dong","big_ind","store_cnt","sim_store_cnt","open_rat","open_cnt","close_rat","close_cnt","franchise_cnt"
20231,"금호1가동","한식음식점",16,18,0,0,11,2,2
20231,"금호1가동","중식음식점",1,4,0,0,0,0,3
20231,"금호1가동","일식음식점",4,4,0,0,0,0,0
20231,"금호1가동","양식음식점",8,8,0,0,13,1,0
20231,"금호1가동","제과점",2,3,0,0,0,0,1
20231,"금호1가동","패스트푸드점",1,5,0,0,80,4,4
20231,"금호1가동","치킨전문점",3,7,0,0,0,0,4
20231,"금호1가동","분식전문점",10,12,8,1,8,1,2
20231,"금호1가동","호프-간이주점",6,7,0,0,0,0,1
20231,"금호1가동","커피-음료",17,21,10,2,0,0,4
20231,"금호1가동","슈퍼마켓",9,11,9,1,9,1,2
20231,"금호1가동","미곡판매",4,4,0,0,0,0,0
20231,"금호1가동","육류판매",4,4,0,0,0,0,0
20231,"금호1가동","수산물판매",3,3,0,0,0,0,0
20231,"금호1가동","청과상",7,7,0,0,14,1,0
20231,"금호1가동","반찬가게",4,4,0,0,25,1,0
20231,"금호2.3가동","한식음식점",100,112,0,0,1,1,12
20231,"금호2.3가동","중식음식점",7,8,0,0,0,0,1
20231,"금호2.3가동","일식음식점",5,6,0,0,0,0,1
20231,"금호2.3가동","양식음식점",19,20,5,1,0,0,1
20231,"금호2.3가동","제과점",9,12,0,0,0,0,3
20231,"금호2.3가동","패스트푸드점",1,11,0,0,0,0,10
20231,"금호2.3가동","치킨전문점",9,19,0,0,0,0,10
20231,"금호2.3가동","분식전문점",14,18,6,1,0,0,4
20231,"금호2.3가동","호프-간이주점",27,28,7,2,4,1,1
20231,"금호2.3가동","커피-음료",25,30,10,3,13,4,5
20231,"금호2.3가동","슈퍼마켓",14,18,0,0,6,1,4
20231,"금호2.3가동","미곡판매",3,3,0,0,0,0,0
20231,"금호2.3가동","육류판매",14,14,0,0,0,0,0
20231,"금호2.3가동","수산물판매",5,5,0,0,0,0,0
20231,"금호2.3가동","청과상",5,5,0,0,0,0,0
20231,"금호2.3가동","반찬가게",13,13,8,1,15,2,0
20231,"금호4가동","한식음식점",48,52,0,0,10,5,4
20231,"금호4가동","중식음식점",4,5,20,1,0,0,1
20231,"금호4가동","일식음식점",5,5,0,0,0,0,0
20231,"금호4가동","양식음식점",6,6,0,0,0,0,0
20231,"금호4가동","제과점",5,9,11,1,0,0,4
20231,"금호4가동","패스트푸드점",3,7,14,1,0,0,4
20231,"금호4가동","치킨전문점",2,9,0,0,0,0,7
20231,"금호4가동","분식전문점",6,11,0,0,0,0,5
20231,"금호4가동","호프-간이주점",19,19,11,2,0,0,0
20231,"금호4가동","커피-음료",19,25,0,0,4,1,6
20231,"금호4가동","슈퍼마켓",7,9,0,0,0,0,2
20231,"금호4가동","미곡판매",1,1,0,0,0,0,0
20231,"금호4가동","육류판매",2,2,0,0,0,0,0
20231,"금호4가동","수산물판매",1,1,0,0,0,0,0
20231,"금호4가동","청과상",6,6,0,0,0,0,0
20231,"금호4가동","반찬가게",3,3,0,0,0,0,0
20231,"마장동","한식음식점",119,124,2,2,2,2,5
20231,"마장동","중식음식점",7,7,0,0,14,1,0
20231,"마장동","일식음식점",3,3,0,0,0,0,0
20231,"마장동","양식음식점",4,5,0,0,0,0,1
20231,"마장동","제과점",2,4,25,1,0,0,2
20231,"마장동","패스트푸드점",4,6,0,0,0,0,2
20231,"마장동","치킨전문점",2,11,0,0,0,0,9
20231,"마장동","분식전문점",10,13,0,0,0,0,3
20231,"마장동","호프-간이주점",18,22,0,0,0,0,4
20231,"마장동","커피-음료",24,29,0,0,3,1,5
20231,"마장동","슈퍼마켓",29,32,0,0,0,0,3
20231,"마장동","미곡판매",2,2,0,0,0,0,0
20231,"마장동","육류판매",1625,1625,1,16,1,21,0
20231,"마장동","수산물판매",1,1,0,0,0,0,0
20231,"마장동","청과상",18,18,0,0,6,1,0
20231,"마장동","반찬가게",13,13,8,1,0,0,0
20231,"사근동","한식음식점",106,132,3,4,2,3,26
20231,"사근동","중식음식점",13,21,10,2,5,1,8
20231,"사근동","일식음식점",21,24,4,1,0,0,3
20231,"사근동","양식음식점",23,30,0,0,3,1,7
20231,"사근동","제과점",2,7,0,0,0,0,5
20231,"사근동","패스트푸드점",12,28,4,1,0,0,16
20231,"사근동","치킨전문점",9,20,0,0,0,0,11
20231,"사근동","분식전문점",21,34,3,1,3,1,13
20231,"사근동","호프-간이주점",55,73,3,2,3,2,18
20231,"사근동","커피-음료",65,92,5,5,3,3,27
20231,"사근동","슈퍼마켓",14,17,6,1,0,0,3
20231,"사근동","미곡판매",3,3,0,0,0,0,0
20231,"사근동","육류판매",4,4,0,0,0,0,0
20231,"사근동","청과상",1,1,0,0,0,0,0
20231,"사근동","반찬가게",5,5,0,0,0,0,0
20231,"성수1가제1동","한식음식점",65,70,1,1,3,2,5
20231,"성수1가제1동","중식음식점",10,12,0,0,0,0,2
20231,"성수1가제1동","일식음식점",11,12,0,0,0,0,1
20231,"성수1가제1동","양식음식점",43,46,7,3,0,0,3
20231,"성수1가제1동","제과점",16,17,6,1,0,0,1
20231,"성수1가제1동","패스트푸드점",13,17,0,0,6,1,4
20231,"성수1가제1동","치킨전문점",1,8,0,0,0,0,7
20231,"성수1가제1동","분식전문점",14,15,7,1,13,2,1
20231,"성수1가제1동","호프-간이주점",23,23,17,4,0,0,0
20231,"성수1가제1동","커피-음료",66,76,4,3,3,2,10
20231,"성수1가제1동","슈퍼마켓",10,19,0,0,5,1,9
20231,"성수1가제1동","미곡판매",3,3,0,0,0,0,0
20231,"성수1가제1동","육류판매",6,6,0,0,0,0,0
20231,"성수1가제1동","수산물판매",2,2,0,0,0,0,0
20231,"성수1가제1동","청과상",5,5,0,0,0,0,0
20231,"성수1가제1동","반찬가게",13,13,8,1,0,0,0
20231,"성수1가제2동","한식음식점",160,178,5,9,10,18,18
20231,"성수1가제2동","중식음식점",16,17,6,1,0,0,1
20231,"성수1가제2동","일식음식점",45,49,6,3,0,0,4
20231,"성수1가제2동","양식음식점",91,92,4,4,0,0,1
20231,"성수1가제2동","제과점",40,41,10,4,5,2,1
20231,"성수1가제2동","패스트푸드점",20,27,7,2,4,1,7
20231,"성수1가제2동","치킨전문점",4,13,8,1,8,1,9
20231,"성수1가제2동","분식전문점",18,26,15,4,4,1,8
20231,"성수1가제2동","호프-간이주점",49,57,5,3,11,6,8
20231,"성수1가제2동","커피-음료",198,222,7,15,2,5,24
20231,"성수1가제2동","슈퍼마켓",13,19,5,1,0,0,6
20231,"성수1가제2동","미곡판매",5,5,0,0,0,0,0
20231,"성수1가제2동","육류판매",13,13,8,1,8,1,0
20231,"성수1가제2동","수산물판매",3,3,0,0,33,1,0
20231,"성수1가제2동","청과상",4,4,25,1,25,1,0
20231,"성수1가제2동","반찬가게",37,39,3,1,0,0,2
20231,"성수2가제1동","한식음식점",151,168,1,1,3,5,17
20231,"성수2가제1동","중식음식점",10,10,0,0,0,0,0
20231,"성수2가제1동","일식음식점",16,17,6,1,0,0,1
20231,"성수2가제1동","양식음식점",46,50,6,3,2,1,4
20231,"성수2가제1동","제과점",26,28,11,3,4,1,2
20231,"성수2가제1동","패스트푸드점",17,23,9,2,9,2,6
20231,"성수2가제1동","치킨전문점",9,15,0,0,0,0,6
20231,"성수2가제1동","분식전문점",25,32,3,1,9,3,7
20231,"성수2가제1동","호프-간이주점",56,61,3,2,0,0,5
20231,"성수2가제1동","커피-음료",87,101,3,3,3,3,14
20231,"성수2가제1동","슈퍼마켓",21,25,0,0,4,1,4
20231,"성수2가제1동","미곡판매",10,10,10,1,0,0,0
20231,"성수2가제1동","육류판매",9,9,0,0,0,0,0
20231,"성수2가제1동","수산물판매",10,10,0,0,10,1,0
20231,"성수2가제1동","청과상",16,16,0,0,0,0,0
20231,"성수2가제1동","반찬가게",31,31,0,0,3,1,0
20231,"성수2가제3동","한식음식점",258,293,6,16,2,7,35
20231,"성수2가제3동","중식음식점",22,29,3,1,7,2,7
20231,"성수2가제3동","일식음식점",43,51,2,1,4,2,8
20231,"성수2가제3동","양식음식점",61,67,9,6,5,3,6
20231,"성수2가제3동","제과점",27,34,6,2,9,3,7
20231,"성수2가제3동","패스트푸드점",23,38,5,2,8,3,15
20231,"성수2가제3동","치킨전문점",5,14,0,0,7,1,9
20231,"성수2가제3동","분식전문점",25,31,3,1,10,3,6
20231,"성수2가제3동","호프-간이주점",55,67,3,2,3,2,12
20231,"성수2가제3동","커피-음료",148,184,7,13,4,8,36
20231,"성수2가제3동","슈퍼마켓",24,39,0,0,0,0,15
20231,"성수2가제3동","미곡판매",5,5,0,0,0,0,0
20231,"성수2가제3동","육류판매",20,20,0,0,0,0,0
20231,"성수2가제3동","수산물판매",2,2,0,0,50,1,0
20231,"성수2가제3동","청과상",12,12,8,1,8,1,0
20231,"성수2가제3동","반찬가게",67,68,2,1,2,1,1
20231,"송정동","한식음식점",37,39,3,1,3,1,2
20231,"송정동","중식음식점",2,2,0,0,0,0,0
20231,"송정동","일식음식점",1,1,0,0,0,0,0
20231,"송정동","양식음식점",3,3,33,1,0,0,0
20231,"송정동","제과점",6,6,0,0,17,1,0
20231,"송정동","패스트푸드점",4,5,20,1,20,1,1
20231,"송정동","치킨전문점",3,4,25,1,0,0,1
20231,"송정동","분식전문점",8,8,0,0,13,1,0
20231,"송정동","호프-간이주점",4,4,0,0,25,1,0
20231,"송정동","커피-음료",20,22,5,1,5,1,2
20231,"송정동","슈퍼마켓",9,11,0,0,9,1,2
20231,"송정동","미곡판매",2,2,0,0,0,0,0
20231,"송정동","육류판매",6,6,0,0,0,0,0
20231,"송정동","수산물판매",2,2,0,0,0,0,0
20231,"송정동","청과상",3,3,0,0,0,0,0
20231,"송정동","반찬가게",3,3,0,0,0,0,0
20231,"옥수동","한식음식점",53,58,2,1,5,3,5
20231,"옥수동","중식음식점",6,7,0,0,0,0,1
20231,"옥수동","일식음식점",8,9,0,0,0,0,1
20231,"옥수동","양식음식점",10,10,10,1,0,0,0
20231,"옥수동","제과점",10,13,0,0,0,0,3
20231,"옥수동","패스트푸드점",8,12,0,0,8,1,4
20231,"옥수동","치킨전문점",3,9,0,0,22,2,6
20231,"옥수동","분식전문점",12,18,0,0,0,0,6
20231,"옥수동","호프-간이주점",9,11,18,2,0,0,2
20231,"옥수동","커피-음료",21,27,0,0,4,1,6
20231,"옥수동","슈퍼마켓",8,15,0,0,7,1,7
20231,"옥수동","미곡판매",2,2,0,0,0,0,0
20231,"옥수동","육류판매",8,9,0,0,0,0,1
20231,"옥수동","수산물판매",3,3,0,0,0,0,0
20231,"옥수동","청과상",4,4,0,0,0,0,0
20231,"옥수동","반찬가게",11,13,0,0,0,0,2
20231,"왕십리도선동","한식음식점",174,216,5,10,5,11,42
20231,"왕십리도선동","중식음식점",16,18,0,0,0,0,2
20231,"왕십리도선동","일식음식점",17,21,14,3,19,4,4
20231,"왕십리도선동","양식음식점",24,27,7,2,0,0,3
20231,"왕십리도선동","제과점",15,23,4,1,4,1,8
20231,"왕십리도선동","패스트푸드점",8,23,17,4,17,4,15
20231,"왕십리도선동","치킨전문점",5,24,4,1,0,0,19
20231,"왕십리도선동","분식전문점",41,58,7,4,3,2,17
20231,"왕십리도선동","호프-간이주점",47,50,6,3,6,3,3
20231,"왕십리도선동","커피-음료",48,73,7,5,6,4,25
20231,"왕십리도선동","슈퍼마켓",26,35,6,2,9,3,9
20231,"왕십리도선동","미곡판매",9,9,11,1,0,0,0
20231,"왕십리도선동","육류판매",60,60,0,0,2,1,0
20231,"왕십리도선동","수산물판매",8,8,0,0,25,2,0
20231,"왕십리도선동","청과상",16,16,13,2,0,0,0
20231,"왕십리도선동","반찬가게",25,26,0,0,0,0,1
20231,"왕십리제2동","한식음식점",47,50,2,1,2,1,3
20231,"왕십리제2동","중식음식점",4,6,0,0,0,0,2
20231,"왕십리제2동","일식음식점",4,4,0,0,0,0,0
20231,"왕십리제2동","양식음식점",4,6,33,2,17,1,2
20231,"왕십리제2동","제과점",8,9,11,1,0,0,1
20231,"왕십리제2동","패스트푸드점",2,10,20,2,20,2,8
20231,"왕십리제2동","치킨전문점",7,12,0,0,8,1,5
20231,"왕십리제2동","분식전문점",10,13,23,3,0,0,3
20231,"왕십리제2동","호프-간이주점",5,6,0,0,0,0,1
20231,"왕십리제2동","커피-음료",19,23,4,1,4,1,4
20231,"왕십리제2동","슈퍼마켓",10,15,0,0,0,0,5
20231,"왕십리제2동","미곡판매",3,3,0,0,0,0,0
20231,"왕십리제2동","육류판매",6,6,0,0,0,0,0
20231,"왕십리제2동","수산물판매",2,2,50,1,0,0,0
20231,"왕십리제2동","청과상",7,7,0,0,14,1,0
20231,"왕십리제2동","반찬가게",5,5,0,0,0,0,0
20231,"용답동","한식음식점",108,119,2,2,1,1,11
20231,"용답동","중식음식점",8,8,0,0,0,0,0
20231,"용답동","일식음식점",8,8,0,0,0,0,0
20231,"용답동","양식음식점",6,7,0,0,14,1,1
20231,"용답동","제과점",3,4,0,0,0,0,1
20231,"용답동","패스트푸드점",3,5,20,1,0,0,2
20231,"용답동","치킨전문점",2,10,0,0,0,0,8
20231,"용답동","분식전문점",10,14,0,0,0,0,4
20231,"용답동","호프-간이주점",24,28,0,0,0,0,4
20231,"용답동","커피-음료",31,41,2,1,5,2,10
20231,"용답동","슈퍼마켓",28,29,7,2,3,1,1
20231,"용답동","미곡판매",4,4,0,0,0,0,0
20231,"용답동","육류판매",26,26,4,1,0,0,0
20231,"용답동","수산물판매",5,5,0,0,40,2,0
20231,"용답동","청과상",10,10,10,1,20,2,0
20231,"용답동","반찬가게",8,8,0,0,25,2,0
20231,"응봉동","한식음식점",9,9,0,0,0,0,0
20231,"응봉동","중식음식점",1,1,0,0,0,0,0
20231,"응봉동","양식음식점",2,2,0,0,0,0,0
20231,"응봉동","제과점",1,2,0,0,0,0,1
20231,"응봉동","패스트푸드점",0,1,0,0,0,0,1
20231,"응봉동","치킨전문점",1,6,0,0,0,0,5
20231,"응봉동","분식전문점",4,4,0,0,0,0,0
20231,"응봉동","호프-간이주점",0,1,0,0,0,0,1
20231,"응봉동","커피-음료",8,10,0,0,0,0,2
20231,"응봉동","슈퍼마켓",11,12,0,0,8,1,1
20231,"응봉동","미곡판매",2,2,0,0,0,0,0
20231,"응봉동","육류판매",4,4,0,0,0,0,0
20231,"응봉동","수산물판매",2,2,0,0,0,0,0
20231,"응봉동","청과상",4,4,0,0,0,0,0
20231,"응봉동","반찬가게",7,7,14,1,14,1,0
20231,"행당제1동","한식음식점",104,132,2,3,2,2,28
20231,"행당제1동","중식음식점",11,12,0,0,8,1,1
20231,"행당제1동","일식음식점",15,18,11,2,0,0,3
20231,"행당제1동","양식음식점",18,27,0,0,0,0,9
20231,"행당제1동","제과점",15,25,4,1,0,0,10
20231,"행당제1동","패스트푸드점",8,20,5,1,0,0,12
20231,"행당제1동","치킨전문점",5,17,0,0,6,1,12
20231,"행당제1동","분식전문점",30,35,0,0,6,2,5
20231,"행당제1동","호프-간이주점",16,17,6,1,0,0,1
20231,"행당제1동","커피-음료",40,56,7,4,2,1,16
20231,"행당제1동","슈퍼마켓",15,19,0,0,5,1,4
20231,"행당제1동","미곡판매",6,6,0,0,0,0,0
20231,"행당제1동","육류판매",35,35,0,0,0,0,0
20231,"행당제1동","수산물판매",8,8,0,0,0,0,0
20231,"행당제1동","청과상",5,5,0,0,0,0,0
20231,"행당제1동","반찬가게",17,17,0,0,0,0,0
20231,"행당제2동","한식음식점",16,20,10,2,15,3,4
20231,"행당제2동","중식음식점",1,2,0,0,0,0,1
20231,"행당제2동","일식음식점",3,3,0,0,0,0,0
20231,"행당제2동","양식음식점",2,2,0,0,0,0,0
20231,"행당제2동","제과점",7,10,10,1,0,0,3
20231,"행당제2동","패스트푸드점",2,6,0,0,0,0,4
20231,"행당제2동","치킨전문점",1,11,0,0,0,0,10
20231,"행당제2동","분식전문점",4,9,0,0,11,1,5
20231,"행당제2동","호프-간이주점",3,6,17,1,0,0,3
20231,"행당제2동","커피-음료",10,17,6,1,6,1,7
20231,"행당제2동","슈퍼마켓",3,5,0,0,0,0,2
20231,"행당제2동","미곡판매",1,1,0,0,0,0,0
20231,"행당제2동","육류판매",4,4,0,0,0,0,0
20231,"행당제2동","수산물판매",3,3,0,0,0,0,0
20231,"행당제2동","청과상",7,7,0,0,14,1,0
20231,"행당제2동","반찬가게",11,12,0,0,0,0,1
20232,"금호1가동","한식음식점",17,21,14,3,0,0,4
20232,"금호1가동","중식음식점",1,4,0,0,0,0,3
20232,"금호1가동","일식음식점",4,4,0,0,0,0,0
20232,"금호1가동","양식음식점",8,8,0,0,0,0,0
20232,"금호1가동","제과점",2,3,0,0,0,0,1
20232,"금호1가동","패스트푸드점",1,6,17,1,0,0,5
20232,"금호1가동","치킨전문점",3,6,0,0,17,1,3
20232,"금호1가동","분식전문점",10,12,0,0,0,0,2
20232,"금호1가동","호프-간이주점",7,8,13,1,0,0,1
20232,"금호1가동","커피-음료",16,20,0,0,5,1,4
20232,"금호1가동","슈퍼마켓",9,11,0,0,0,0,2
20232,"금호1가동","미곡판매",4,4,0,0,0,0,0
20232,"금호1가동","육류판매",4,4,0,0,0,0,0
20232,"금호1가동","수산물판매",3,3,0,0,0,0,0
20232,"금호1가동","청과상",7,7,14,1,14,1,0
20232,"금호1가동","반찬가게",4,4,0,0,0,0,0
20232,"금호2.3가동","한식음식점",102,115,4,4,1,1,13
20232,"금호2.3가동","중식음식점",6,7,0,0,14,1,1
20232,"금호2.3가동","일식음식점",5,6,0,0,0,0,1
20232,"금호2.3가동","양식음식점",18,19,5,1,11,2,1
20232,"금호2.3가동","제과점",8,11,0,0,9,1,3
20232,"금호2.3가동","패스트푸드점",1,11,0,0,0,0,10
20232,"금호2.3가동","치킨전문점",9,18,6,1,11,2,9
20232,"금호2.3가동","분식전문점",16,20,10,2,0,0,4
20232,"금호2.3가동","호프-간이주점",28,29,7,2,3,1,1
20232,"금호2.3가동","커피-음료",24,29,0,0,3,1,5
20232,"금호2.3가동","슈퍼마켓",16,20,10,2,0,0,4
20232,"금호2.3가동","미곡판매",3,3,0,0,0,0,0
20232,"금호2.3가동","육류판매",15,15,7,1,0,0,0
20232,"금호2.3가동","수산물판매",5,5,0,0,0,0,0
20232,"금호2.3가동","청과상",5,5,0,0,0,0,0
20232,"금호2.3가동","반찬가게",13,13,0,0,0,0,0
20232,"금호4가동","한식음식점",49,53,2,1,0,0,4
20232,"금호4가동","중식음식점",4,5,0,0,0,0,1
20232,"금호4가동","일식음식점",5,5,0,0,0,0,0
20232,"금호4가동","양식음식점",5,5,0,0,20,1,0
20232,"금호4가동","제과점",4,8,0,0,13,1,4
20232,"금호4가동","패스트푸드점",2,6,0,0,17,1,4
20232,"금호4가동","치킨전문점",2,9,0,0,0,0,7
20232,"금호4가동","분식전문점",6,11,0,0,0,0,5
20232,"금호4가동","호프-간이주점",19,19,0,0,0,0,0
20232,"금호4가동","커피-음료",20,27,7,2,0,0,7
20232,"금호4가동","슈퍼마켓",7,9,0,0,0,0,2
20232,"금호4가동","미곡판매",1,1,0,0,0,0,0
20232,"금호4가동","육류판매",3,3,33,1,0,0,0
20232,"금호4가동","수산물판매",1,1,0,0,0,0,0
20232,"금호4가동","청과상",8,8,25,2,0,0,0
20232,"금호4가동","반찬가게",3,3,0,0,0,0,0
20232,"마장동","한식음식점",122,127,3,4,1,1,5
20232,"마장동","중식음식점",7,7,0,0,0,0,0
20232,"마장동","일식음식점",3,3,0,0,0,0,0
20232,"마장동","양식음식점",4,5,0,0,0,0,1
20232,"마장동","제과점",2,4,0,0,0,0,2
20232,"마장동","패스트푸드점",4,6,0,0,0,0,2
20232,"마장동","치킨전문점",2,10,0,0,10,1,8
20232,"마장동","분식전문점",10,13,0,0,0,0,3
20232,"마장동","호프-간이주점",17,21,0,0,5,1,4
20232,"마장동","커피-음료",24,29,3,1,3,1,5
20232,"마장동","슈퍼마켓",28,31,0,0,3,1,3
20232,"마장동","미곡판매",2,2,0,0,0,0,0
20232,"마장동","육류판매",1632,1632,2,26,1,19,0
20232,"마장동","수산물판매",1,1,0,0,0,0,0
20232,"마장동","청과상",18,18,0,0,0,0,0
20232,"마장동","반찬가게",13,13,0,0,0,0,0
20232,"사근동","한식음식점",107,133,2,2,1,1,26
20232,"사근동","중식음식점",13,20,0,0,5,1,7
20232,"사근동","일식음식점",21,24,0,0,0,0,3
20232,"사근동","양식음식점",23,29,0,0,3,1,6
20232,"사근동","제과점",2,7,0,0,0,0,5
20232,"사근동","패스트푸드점",12,28,0,0,0,0,16
20232,"사근동","치킨전문점",9,19,0,0,5,1,10
20232,"사근동","분식전문점",18,32,3,1,9,3,14
20232,"사근동","호프-간이주점",52,70,1,1,6,4,18
20232,"사근동","커피-음료",63,90,1,1,3,3,27
20232,"사근동","슈퍼마켓",14,17,0,0,0,0,3
20232,"사근동","미곡판매",3,3,0,0,0,0,0
20232,"사근동","육류판매",4,4,0,0,0,0,0
20232,"사근동","청과상",1,1,0,0,0,0,0
20232,"사근동","반찬가게",5,5,0,0,0,0,0
20232,"성수1가제1동","한식음식점",66,72,4,3,1,1,6
20232,"성수1가제1동","중식음식점",10,12,0,0,0,0,2
20232,"성수1가제1동","일식음식점",11,12,0,0,0,0,1
20232,"성수1가제1동","양식음식점",47,50,10,5,2,1,3
20232,"성수1가제1동","제과점",16,17,0,0,0,0,1
20232,"성수1가제1동","패스트푸드점",11,15,0,0,13,2,4
20232,"성수1가제1동","치킨전문점",1,7,0,0,14,1,6
20232,"성수1가제1동","분식전문점",16,17,12,2,0,0,1
20232,"성수1가제1동","호프-간이주점",22,22,0,0,5,1,0
20232,"성수1가제1동","커피-음료",66,78,8,6,5,4,12
20232,"성수1가제1동","슈퍼마켓",8,17,0,0,12,2,9
20232,"성수1가제1동","미곡판매",3,3,0,0,0,0,0
20232,"성수1가제1동","육류판매",6,6,0,0,0,0,0
20232,"성수1가제1동","수산물판매",2,2,0,0,0,0,0
20232,"성수1가제1동","청과상",4,4,0,0,25,1,0
20232,"성수1가제1동","반찬가게",12,12,0,0,8,1,0
20232,"성수1가제2동","한식음식점",166,184,5,9,2,3,18
20232,"성수1가제2동","중식음식점",17,18,11,2,6,1,1
20232,"성수1가제2동","일식음식점",47,51,6,3,2,1,4
20232,"성수1가제2동","양식음식점",95,97,8,8,3,3,2
20232,"성수1가제2동","제과점",42,43,5,2,0,0,1
20232,"성수1가제2동","패스트푸드점",22,29,14,4,7,2,7
20232,"성수1가제2동","치킨전문점",4,13,0,0,0,0,9
20232,"성수1가제2동","분식전문점",17,25,4,1,8,2,8
20232,"성수1가제2동","호프-간이주점",52,60,10,6,5,3,8
20232,"성수1가제2동","커피-음료",199,224,5,11,4,9,25
20232,"성수1가제2동","슈퍼마켓",13,19,0,0,0,0,6
20232,"성수1가제2동","미곡판매",5,5,0,0,0,0,0
20232,"성수1가제2동","육류판매",12,12,8,1,17,2,0
20232,"성수1가제2동","수산물판매",3,3,0,0,0,0,0
20232,"성수1가제2동","청과상",4,4,0,0,0,0,0
20232,"성수1가제2동","반찬가게",37,39,0,0,0,0,2
20232,"성수2가제1동","한식음식점",146,162,3,5,7,11,16
20232,"성수2가제1동","중식음식점",10,11,9,1,0,0,1
20232,"성수2가제1동","일식음식점",19,20,15,3,0,0,1
20232,"성수2가제1동","양식음식점",46,49,8,4,10,5,3
20232,"성수2가제1동","제과점",26,28,4,1,4,1,2
20232,"성수2가제1동","패스트푸드점",18,24,8,2,4,1,6
20232,"성수2가제1동","치킨전문점",9,15,0,0,0,0,6
20232,"성수2가제1동","분식전문점",24,30,3,1,10,3,6
20232,"성수2가제1동","호프-간이주점",60,65,6,4,0,0,5
20232,"성수2가제1동","커피-음료",91,103,7,7,5,5,12
20232,"성수2가제1동","슈퍼마켓",22,26,4,1,0,0,4
20232,"성수2가제1동","미곡판매",9,9,0,0,11,1,0
20232,"성수2가제1동","육류판매",9,9,0,0,0,0,0
20232,"성수2가제1동","수산물판매",10,10,0,0,0,0,0
20232,"성수2가제1동","청과상",16,16,0,0,0,0,0
20232,"성수2가제1동","반찬가게",31,31,0,0,0,0,0
20232,"성수2가제3동","한식음식점",248,284,1,3,4,12,36
20232,"성수2가제3동","중식음식점",23,30,3,1,0,0,7
20232,"성수2가제3동","일식음식점",43,51,2,1,2,1,8
20232,"성수2가제3동","양식음식점",65,71,10,7,4,3,6
20232,"성수2가제3동","제과점",28,35,6,2,3,1,7
20232,"성수2가제3동","패스트푸드점",24,39,3,1,0,0,15
20232,"성수2가제3동","치킨전문점",4,13,0,0,8,1,9
20232,"성수2가제3동","분식전문점",25,31,10,3,10,3,6
20232,"성수2가제3동","호프-간이주점",60,71,11,8,6,4,11
20232,"성수2가제3동","커피-음료",146,182,3,6,4,8,36
20232,"성수2가제3동","슈퍼마켓",26,41,5,2,0,0,15
20232,"성수2가제3동","미곡판매",5,5,0,0,0,0,0
20232,"성수2가제3동","육류판매",19,19,0,0,5,1,0
20232,"성수2가제3동","수산물판매",2,2,0,0,0,0,0
20232,"성수2가제3동","청과상",13,13,8,1,0,0,0
20232,"성수2가제3동","반찬가게",71,73,7,5,0,0,2
20232,"송정동","한식음식점",38,40,5,2,3,1,2
20232,"송정동","중식음식점",2,2,0,0,0,0,0
20232,"송정동","일식음식점",1,1,0,0,0,0,0
20232,"송정동","양식음식점",4,4,25,1,0,0,0
20232,"송정동","제과점",6,6,17,1,17,1,0
20232,"송정동","패스트푸드점",4,5,0,0,0,0,1
20232,"송정동","치킨전문점",2,3,0,0,33,1,1
20232,"송정동","분식전문점",7,7,0,0,14,1,0
20232,"송정동","호프-간이주점",4,4,0,0,0,0,0
20232,"송정동","커피-음료",20,22,5,1,5,1,2
20232,"송정동","슈퍼마켓",9,11,0,0,0,0,2
20232,"송정동","미곡판매",2,2,0,0,0,0,0
20232,"송정동","육류판매",6,6,0,0,0,0,0
20232,"송정동","수산물판매",2,2,0,0,0,0,0
20232,"송정동","청과상",4,4,25,1,0,0,0
20232,"송정동","반찬가게",3,3,0,0,0,0,0
20232,"옥수동","한식음식점",54,59,7,4,5,3,5
20232,"옥수동","중식음식점",7,8,13,1,0,0,1
20232,"옥수동","일식음식점",7,7,0,0,29,2,0
20232,"옥수동","양식음식점",10,10,0,0,0,0,0
20232,"옥수동","제과점",10,14,7,1,0,0,4
20232,"옥수동","패스트푸드점",7,11,0,0,9,1,4
20232,"옥수동","치킨전문점",3,9,0,0,0,0,6
20232,"옥수동","분식전문점",11,17,6,1,12,2,6
20232,"옥수동","호프-간이주점",8,9,0,0,22,2,1
20232,"옥수동","커피-음료",22,28,4,1,0,0,6
20232,"옥수동","슈퍼마켓",8,15,0,0,0,0,7
20232,"옥수동","미곡판매",2,2,0,0,0,0,0
20232,"옥수동","육류판매",8,9,0,0,0,0,1
20232,"옥수동","수산물판매",3,3,0,0,0,0,0
20232,"옥수동","청과상",4,4,0,0,0,0,0
20232,"옥수동","반찬가게",11,13,0,0,0,0,2
20232,"왕십리도선동","한식음식점",181,222,5,11,2,5,41
20232,"왕십리도선동","중식음식점",16,19,16,3,11,2,3
20232,"왕십리도선동","일식음식점",17,21,10,2,10,2,4
20232,"왕십리도선동","양식음식점",22,26,4,1,8,2,4
20232,"왕십리도선동","제과점",17,25,8,2,0,0,8
20232,"왕십리도선동","패스트푸드점",11,25,16,4,8,2,14
20232,"왕십리도선동","치킨전문점",5,24,13,3,13,3,19
20232,"왕십리도선동","분식전문점",44,60,8,5,5,3,16
20232,"왕십리도선동","호프-간이주점",47,50,0,0,0,0,3
20232,"왕십리도선동","커피-음료",46,72,3,2,4,3,26
20232,"왕십리도선동","슈퍼마켓",26,34,3,1,6,2,8
20232,"왕십리도선동","미곡판매",9,9,0,0,0,0,0
20232,"왕십리도선동","육류판매",59,59,3,2,5,3,0
20232,"왕십리도선동","수산물판매",9,9,11,1,0,0,0
20232,"왕십리도선동","청과상",16,16,13,2,13,2,0
20232,"왕십리도선동","반찬가게",25,27,4,1,0,0,2
20232,"왕십리제2동","한식음식점",47,50,4,2,4,2,3
20232,"왕십리제2동","중식음식점",5,7,14,1,0,0,2
20232,"왕십리제2동","일식음식점",3,3,0,0,33,1,0
20232,"왕십리제2동","양식음식점",4,5,20,1,40,2,1
20232,"왕십리제2동","제과점",9,10,10,1,0,0,1
20232,"왕십리제2동","패스트푸드점",2,10,20,2,20,2,8
20232,"왕십리제2동","치킨전문점",7,12,0,0,0,0,5
20232,"왕십리제2동","분식전문점",10,13,0,0,0,0,3
20232,"왕십리제2동","호프-간이주점",5,6,0,0,0,0,1
20232,"왕십리제2동","커피-음료",22,25,12,3,4,1,3
20232,"왕십리제2동","슈퍼마켓",11,16,6,1,0,0,5
20232,"왕십리제2동","미곡판매",3,3,0,0,0,0,0
20232,"왕십리제2동","육류판매",6,6,0,0,0,0,0
20232,"왕십리제2동","수산물판매",2,2,0,0,0,0,0
20232,"왕십리제2동","청과상",7,7,14,1,14,1,0
20232,"왕십리제2동","반찬가게",5,5,0,0,0,0,0
20232,"용답동","한식음식점",106,117,2,2,3,4,11
20232,"용답동","중식음식점",8,8,0,0,0,0,0
20232,"용답동","일식음식점",9,9,11,1,0,0,0
20232,"용답동","양식음식점",6,7,0,0,0,0,1
20232,"용답동","제과점",4,5,40,2,20,1,1
20232,"용답동","패스트푸드점",3,5,20,1,20,1,2
20232,"용답동","치킨전문점",2,9,11,1,22,2,7
20232,"용답동","분식전문점",12,18,28,5,6,1,6
20232,"용답동","호프-간이주점",24,27,0,0,4,1,3
20232,"용답동","커피-음료",30,41,5,2,5,2,11
20232,"용답동","슈퍼마켓",28,29,0,0,0,0,1
20232,"용답동","미곡판매",4,4,0,0,0,0,0
20232,"용답동","육류판매",24,24,0,0,8,2,0
20232,"용답동","수산물판매",5,5,0,0,0,0,0
20232,"용답동","청과상",10,10,0,0,0,0,0
20232,"용답동","반찬가게",9,9,11,1,0,0,0
20232,"응봉동","한식음식점",9,9,0,0,0,0,0
20232,"응봉동","중식음식점",1,1,0,0,0,0,0
20232,"응봉동","양식음식점",3,3,33,1,0,0,0
20232,"응봉동","제과점",1,2,0,0,0,0,1
20232,"응봉동","패스트푸드점",0,1,0,0,0,0,1
20232,"응봉동","치킨전문점",1,5,0,0,20,1,4
20232,"응봉동","분식전문점",4,4,0,0,0,0,0
20232,"응봉동","호프-간이주점",0,1,0,0,0,0,1
20232,"응봉동","커피-음료",8,10,0,0,0,0,2
20232,"응봉동","슈퍼마켓",11,12,0,0,0,0,1
20232,"응봉동","미곡판매",2,2,0,0,0,0,0
20232,"응봉동","육류판매",4,4,0,0,0,0,0
20232,"응봉동","수산물판매",1,1,0,0,100,1,0
20232,"응봉동","청과상",4,4,0,0,0,0,0
20232,"응봉동","반찬가게",7,7,0,0,0,0,0
20232,"행당제1동","한식음식점",105,134,5,7,4,5,29
20232,"행당제1동","중식음식점",11,12,0,0,0,0,1
20232,"행당제1동","일식음식점",15,20,10,2,0,0,5
20232,"행당제1동","양식음식점",18,25,0,0,8,2,7
20232,"행당제1동","제과점",15,28,18,5,7,2,13
20232,"행당제1동","패스트푸드점",8,19,0,0,5,1,11
20232,"행당제1동","치킨전문점",6,20,15,3,0,0,14
20232,"행당제1동","분식전문점",33,39,13,5,3,1,6
20232,"행당제1동","호프-간이주점",16,17,0,0,0,0,1
20232,"행당제1동","커피-음료",37,54,2,1,6,3,17
20232,"행당제1동","슈퍼마켓",15,19,0,0,0,0,4
20232,"행당제1동","미곡판매",5,5,0,0,20,1,0
20232,"행당제1동","육류판매",35,35,0,0,0,0,0
20232,"행당제1동","수산물판매",8,8,0,0,0,0,0
20232,"행당제1동","청과상",5,5,0,0,0,0,0
20232,"행당제1동","반찬가게",16,16,0,0,6,1,0
20232,"행당제2동","한식음식점",15,18,0,0,11,2,3
20232,"행당제2동","중식음식점",1,3,33,1,0,0,2
20232,"행당제2동","일식음식점",3,3,0,0,0,0,0
20232,"행당제2동","양식음식점",2,2,0,0,0,0,0
20232,"행당제2동","제과점",7,10,0,0,0,0,3
20232,"행당제2동","패스트푸드점",3,6,17,1,17,1,3
20232,"행당제2동","치킨전문점",1,11,0,0,0,0,10
20232,"행당제2동","분식전문점",3,10,20,2,10,1,7
20232,"행당제2동","호프-간이주점",3,5,20,1,40,2,2
20232,"행당제2동","커피-음료",10,17,0,0,0,0,7
20232,"행당제2동","슈퍼마켓",4,7,29,2,0,0,3
20232,"행당제2동","미곡판매",1,1,0,0,0,0,0
20232,"행당제2동","육류판매",4,4,0,0,0,0,0
20232,"행당제2동","수산물판매",3,3,0,0,0,0,0
20232,"행당제2동","청과상",7,7,0,0,0,0,0
20232,"행당제2동","반찬가게",11,12,0,0,0,0,1
20233,"금호1가동","한식음식점",18,22,5,1,0,0,4
20233,"금호1가동","중식음식점",1,3,0,0,33,1,2
20233,"금호1가동","일식음식점",4,4,0,0,0,0,0
20233,"금호1가동","양식음식점",8,8,0,0,0,0,0
20233,"금호1가동","제과점",2,3,0,0,0,0,1
20233,"금호1가동","패스트푸드점",2,6,17,1,17,1,4
20233,"금호1가동","치킨전문점",3,6,33,2,33,2,3
20233,"금호1가동","분식전문점",11,13,8,1,0,0,2
20233,"금호1가동","호프-간이주점",7,8,0,0,0,0,1
20233,"금호1가동","커피-음료",14,18,0,0,11,2,4
20233,"금호1가동","슈퍼마켓",9,11,0,0,0,0,2
20233,"금호1가동","미곡판매",4,4,0,0,0,0,0
20233,"금호1가동","육류판매",5,5,20,1,0,0,0
20233,"금호1가동","수산물판매",3,3,0,0,0,0,0
20233,"금호1가동","청과상",7,7,0,0,0,0,0
20233,"금호1가동","반찬가게",4,4,0,0,0,0,0
20233,"금호2.3가동","한식음식점",103,116,2,2,1,1,13
20233,"금호2.3가동","중식음식점",6,7,0,0,0,0,1
20233,"금호2.3가동","일식음식점",5,6,0,0,0,0,1
20233,"금호2.3가동","양식음식점",17,18,0,0,6,1,1
20233,"금호2.3가동","제과점",8,11,0,0,0,0,3
20233,"금호2.3가동","패스트푸드점",1,9,0,0,22,2,8
20233,"금호2.3가동","치킨전문점",9,18,0,0,0,0,9
20233,"금호2.3가동","분식전문점",18,22,9,2,0,0,4
20233,"금호2.3가동","호프-간이주점",28,29,0,0,0,0,1
20233,"금호2.3가동","커피-음료",24,29,7,2,7,2,5
20233,"금호2.3가동","슈퍼마켓",15,19,0,0,5,1,4
20233,"금호2.3가동","미곡판매",3,3,33,1,33,1,0
20233,"금호2.3가동","육류판매",15,15,7,1,7,1,0
20233,"금호2.3가동","수산물판매",5,5,0,0,0,0,0
20233,"금호2.3가동","청과상",5,5,20,1,20,1,0
20233,"금호2.3가동","반찬가게",12,13,8,1,8,1,1
20233,"금호4가동","한식음식점",48,52,6,3,8,4,4
20233,"금호4가동","중식음식점",4,5,0,0,0,0,1
20233,"금호4가동","일식음식점",4,4,0,0,25,1,0
20233,"금호4가동","양식음식점",4,4,0,0,25,1,0
20233,"금호4가동","제과점",4,8,0,0,0,0,4
20233,"금호4가동","패스트푸드점",2,6,0,0,0,0,4
20233,"금호4가동","치킨전문점",1,7,0,0,29,2,6
20233,"금호4가동","분식전문점",6,12,8,1,0,0,6
20233,"금호4가동","호프-간이주점",19,19,0,0,0,0,0
20233,"금호4가동","커피-음료",20,28,4,1,0,0,8
20233,"금호4가동","슈퍼마켓",7,9,0,0,0,0,2
20233,"금호4가동","미곡판매",1,1,0,0,0,0,0
20233,"금호4가동","육류판매",3,3,0,0,0,0,0
20233,"금호4가동","수산물판매",1,1,0,0,0,0,0
20233,"금호4가동","청과상",8,8,0,0,0,0,0
20233,"금호4가동","반찬가게",3,3,0,0,0,0,0
20233,"마장동","한식음식점",122,127,2,2,2,2,5
20233,"마장동","중식음식점",5,5,0,0,40,2,0
20233,"마장동","일식음식점",3,3,0,0,0,0,0
20233,"마장동","양식음식점",4,5,0,0,0,0,1
20233,"마장동","제과점",2,4,0,0,0,0,2
20233,"마장동","패스트푸드점",4,6,0,0,0,0,2
20233,"마장동","치킨전문점",2,10,0,0,0,0,8
20233,"마장동","분식전문점",10,13,0,0,0,0,3
20233,"마장동","호프-간이주점",18,22,5,1,0,0,4
20233,"마장동","커피-음료",22,27,4,1,11,3,5
20233,"마장동","슈퍼마켓",28,31,3,1,3,1,3
20233,"마장동","미곡판매",2,2,0,0,0,0,0
20233,"마장동","육류판매",1630,1630,1,16,1,18,0
20233,"마장동","수산물판매",2,2,50,1,0,0,0
20233,"마장동","청과상",18,18,0,0,0,0,0
20233,"마장동","반찬가게",14,14,7,1,0,0,0
20233,"사근동","한식음식점",108,134,2,3,2,2,26
20233,"사근동","중식음식점",13,21,5,1,0,0,8
20233,"사근동","일식음식점",19,22,0,0,9,2,3
20233,"사근동","양식음식점",25,31,7,2,0,0,6
20233,"사근동","제과점",2,7,0,0,0,0,5
20233,"사근동","패스트푸드점",13,29,3,1,0,0,16
20233,"사근동","치킨전문점",9,19,0,0,0,0,10
20233,"사근동","분식전문점",17,30,0,0,7,2,13
20233,"사근동","호프-간이주점",53,70,3,2,3,2,17
20233,"사근동","커피-음료",65,92,3,3,1,1,27
20233,"사근동","슈퍼마켓",15,18,6,1,0,0,3
20233,"사근동","미곡판매",3,3,0,0,0,0,0
20233,"사근동","육류판매",4,4,0,0,0,0,0
20233,"사근동","청과상",1,1,0,0,0,0,0
20233,"사근동","반찬가게",5,5,0,0,0,0,0
20233,"성수1가제1동","한식음식점",66,72,3,2,3,2,6
20233,"성수1가제1동","중식음식점",10,12,0,0,0,0,2
20233,"성수1가제1동","일식음식점",12,13,8,1,0,0,1
20233,"성수1가제1동","양식음식점",46,49,2,1,4,2,3
20233,"성수1가제1동","제과점",18,20,15,3,0,0,2
20233,"성수1가제1동","패스트푸드점",11,15,7,1,7,1,4
20233,"성수1가제1동","치킨전문점",1,7,0,0,0,0,6
20233,"성수1가제1동","분식전문점",19,21,19,4,0,0,2
20233,"성수1가제1동","호프-간이주점",22,22,9,2,9,2,0
20233,"성수1가제1동","커피-음료",65,78,4,3,4,3,13
20233,"성수1가제1동","슈퍼마켓",8,17,0,0,0,0,9
20233,"성수1가제1동","미곡판매",3,3,0,0,0,0,0
20233,"성수1가제1동","육류판매",5,5,0,0,20,1,0
20233,"성수1가제1동","수산물판매",2,2,0,0,0,0,0
20233,"성수1가제1동","청과상",5,5,20,1,0,0,0
20233,"성수1가제1동","반찬가게",12,12,0,0,0,0,0
20233,"성수1가제2동","한식음식점",171,189,6,11,3,6,18
20233,"성수1가제2동","중식음식점",17,18,0,0,0,0,1
20233,"성수1가제2동","일식음식점",47,51,8,4,8,4,4
20233,"성수1가제2동","양식음식점",95,97,4,4,4,4,2
20233,"성수1가제2동","제과점",47,48,13,6,2,1,1
20233,"성수1가제2동","패스트푸드점",22,28,4,1,7,2,6
20233,"성수1가제2동","치킨전문점",4,12,0,0,8,1,8
20233,"성수1가제2동","분식전문점",19,27,7,2,0,0,8
20233,"성수1가제2동","호프-간이주점",52,61,3,2,2,1,9
20233,"성수1가제2동","커피-음료",202,227,5,12,4,9,25
20233,"성수1가제2동","슈퍼마켓",14,20,15,3,10,2,6
20233,"성수1가제2동","미곡판매",5,5,0,0,0,0,0
20233,"성수1가제2동","육류판매",12,12,0,0,0,0,0
20233,"성수1가제2동","수산물판매",4,4,25,1,0,0,0
20233,"성수1가제2동","청과상",4,4,0,0,0,0,0
20233,"성수1가제2동","반찬가게",37,39,0,0,0,0,2
20233,"성수2가제1동","한식음식점",143,157,5,8,8,13,14
20233,"성수2가제1동","중식음식점",10,11,0,0,0,0,1
20233,"성수2가제1동","일식음식점",17,18,0,0,11,2,1
20233,"성수2가제1동","양식음식점",48,51,12,6,8,4,3
20233,"성수2가제1동","제과점",29,31,13,4,3,1,2
20233,"성수2가제1동","패스트푸드점",21,27,19,5,7,2,6
20233,"성수2가제1동","치킨전문점",7,13,0,0,15,2,6
20233,"성수2가제1동","분식전문점",27,33,9,3,0,0,6
20233,"성수2가제1동","호프-간이주점",59,64,3,2,5,3,5
20233,"성수2가제1동","커피-음료",92,104,8,8,7,7,12
20233,"성수2가제1동","슈퍼마켓",20,24,0,0,8,2,4
20233,"성수2가제1동","미곡판매",9,9,0,0,0,0,0
20233,"성수2가제1동","육류판매",9,9,0,0,0,0,0
20233,"성수2가제1동","수산물판매",10,10,0,0,0,0,0
20233,"성수2가제1동","청과상",16,16,6,1,6,1,0
20233,"성수2가제1동","반찬가게",30,30,0,0,3,1,0
20233,"성수2가제3동","한식음식점",248,284,4,10,4,10,36
20233,"성수2가제3동","중식음식점",24,31,7,2,3,1,7
20233,"성수2가제3동","일식음식점",47,56,9,5,0,0,9
20233,"성수2가제3동","양식음식점",67,72,7,5,6,4,5
20233,"성수2가제3동","제과점",29,36,6,2,3,1,7
20233,"성수2가제3동","패스트푸드점",23,37,0,0,5,2,14
20233,"성수2가제3동","치킨전문점",4,11,0,0,18,2,7
20233,"성수2가제3동","분식전문점",27,33,9,3,3,1,6
20233,"성수2가제3동","호프-간이주점",59,70,3,2,4,3,11
20233,"성수2가제3동","커피-음료",153,190,7,14,3,6,37
20233,"성수2가제3동","슈퍼마켓",26,41,0,0,0,0,15
20233,"성수2가제3동","미곡판매",5,5,0,0,0,0,0
20233,"성수2가제3동","육류판매",19,19,0,0,0,0,0
20233,"성수2가제3동","수산물판매",2,2,0,0,0,0,0
20233,"성수2가제3동","청과상",13,13,0,0,0,0,0
20233,"성수2가제3동","반찬가게",73,75,3,2,0,0,2
20233,"송정동","한식음식점",39,41,5,2,2,1,2
20233,"송정동","중식음식점",2,2,0,0,0,0,0
20233,"송정동","일식음식점",2,2,50,1,0,0,0
20233,"송정동","양식음식점",4,4,0,0,0,0,0
20233,"송정동","제과점",6,6,17,1,17,1,0
20233,"송정동","패스트푸드점",4,5,0,0,0,0,1
20233,"송정동","치킨전문점",3,4,25,1,0,0,1
20233,"송정동","분식전문점",6,6,0,0,17,1,0
20233,"송정동","호프-간이주점",5,5,20,1,0,0,0
20233,"송정동","커피-음료",23,25,20,5,8,2,2
20233,"송정동","슈퍼마켓",9,11,9,1,9,1,2
20233,"송정동","미곡판매",2,2,0,0,0,0,0
20233,"송정동","육류판매",6,6,17,1,17,1,0
20233,"송정동","수산물판매",2,2,0,0,0,0,0
20233,"송정동","청과상",4,4,0,0,0,0,0
20233,"송정동","반찬가게",2,2,0,0,50,1,0
20233,"옥수동","한식음식점",54,59,2,1,2,1,5
20233,"옥수동","중식음식점",7,8,0,0,0,0,1
20233,"옥수동","일식음식점",7,7,0,0,0,0,0
20233,"옥수동","양식음식점",9,9,0,0,11,1,0
20233,"옥수동","제과점",10,14,0,0,0,0,4
20233,"옥수동","패스트푸드점",8,12,8,1,0,0,4
20233,"옥수동","치킨전문점",3,10,10,1,0,0,7
20233,"옥수동","분식전문점",10,16,0,0,6,1,6
20233,"옥수동","호프-간이주점",8,9,0,0,0,0,1
20233,"옥수동","커피-음료",21,27,0,0,4,1,6
20233,"옥수동","슈퍼마켓",8,15,0,0,0,0,7
20233,"옥수동","미곡판매",2,2,0,0,0,0,0
20233,"옥수동","육류판매",8,9,0,0,0,0,1
20233,"옥수동","수산물판매",3,3,0,0,0,0,0
20233,"옥수동","청과상",4,4,0,0,0,0,0
20233,"옥수동","반찬가게",11,13,0,0,0,0,2
20233,"왕십리도선동","한식음식점",181,223,4,9,4,8,42
20233,"왕십리도선동","중식음식점",15,18,6,1,11,2,3
20233,"왕십리도선동","일식음식점",18,23,9,2,0,0,5
20233,"왕십리도선동","양식음식점",20,24,0,0,8,2,4
20233,"왕십리도선동","제과점",17,25,0,0,0,0,8
20233,"왕십리도선동","패스트푸드점",11,24,0,0,4,1,13
20233,"왕십리도선동","치킨전문점",4,22,0,0,9,2,18
20233,"왕십리도선동","분식전문점",44,60,3,2,3,2,16
20233,"왕십리도선동","호프-간이주점",47,50,4,2,4,2,3
20233,"왕십리도선동","커피-음료",48,75,7,5,3,2,27
20233,"왕십리도선동","슈퍼마켓",26,34,3,1,3,1,8
20233,"왕십리도선동","미곡판매",9,9,0,0,0,0,0
20233,"왕십리도선동","육류판매",59,59,2,1,2,1,0
20233,"왕십리도선동","수산물판매",8,8,0,0,13,1,0
20233,"왕십리도선동","청과상",17,17,6,1,0,0,0
20233,"왕십리도선동","반찬가게",25,27,0,0,0,0,2
20233,"왕십리제2동","한식음식점",46,49,4,2,6,3,3
20233,"왕십리제2동","중식음식점",5,7,0,0,0,0,2
20233,"왕십리제2동","일식음식점",3,3,0,0,0,0,0
20233,"왕십리제2동","양식음식점",5,7,29,2,0,0,2
20233,"왕십리제2동","제과점",8,9,0,0,11,1,1
20233,"왕십리제2동","패스트푸드점",4,11,27,3,18,2,7
20233,"왕십리제2동","치킨전문점",7,12,0,0,0,0,5
20233,"왕십리제2동","분식전문점",10,13,23,3,23,3,3
20233,"왕십리제2동","호프-간이주점",5,6,0,0,0,0,1
20233,"왕십리제2동","커피-음료",21,24,4,1,8,2,3
20233,"왕십리제2동","슈퍼마켓",11,16,0,0,0,0,5
20233,"왕십리제2동","미곡판매",3,3,0,0,0,0,0
20233,"왕십리제2동","육류판매",6,6,0,0,0,0,0
20233,"왕십리제2동","수산물판매",2,2,0,0,0,0,0
20233,"왕십리제2동","청과상",7,7,0,0,0,0,0
20233,"왕십리제2동","반찬가게",5,5,0,0,0,0,0
20233,"용답동","한식음식점",104,115,4,5,6,7,11
20233,"용답동","중식음식점",8,8,0,0,0,0,0
20233,"용답동","일식음식점",9,9,0,0,0,0,0
20233,"용답동","양식음식점",6,7,0,0,0,0,1
20233,"용답동","제과점",4,5,0,0,0,0,1
20233,"용답동","패스트푸드점",3,5,0,0,0,0,2
20233,"용답동","치킨전문점",2,8,0,0,13,1,6
20233,"용답동","분식전문점",12,19,11,2,5,1,7
20233,"용답동","호프-간이주점",24,27,4,1,4,1,3
20233,"용답동","커피-음료",30,41,0,0,0,0,11
20233,"용답동","슈퍼마켓",28,29,0,0,0,0,1
20233,"용답동","미곡판매",4,4,0,0,0,0,0
20233,"용답동","육류판매",23,23,0,0,4,1,0
20233,"용답동","수산물판매",5,5,0,0,0,0,0
20233,"용답동","청과상",10,10,0,0,0,0,0
20233,"용답동","반찬가게",9,9,0,0,0,0,0
20233,"응봉동","한식음식점",9,9,0,0,0,0,0
20233,"응봉동","중식음식점",1,1,0,0,0,0,0
20233,"응봉동","양식음식점",3,3,0,0,0,0,0
20233,"응봉동","제과점",1,2,0,0,0,0,1
20233,"응봉동","패스트푸드점",0,1,0,0,0,0,1
20233,"응봉동","치킨전문점",1,6,17,1,0,0,5
20233,"응봉동","분식전문점",4,4,0,0,0,0,0
20233,"응봉동","호프-간이주점",0,1,0,0,0,0,1
20233,"응봉동","커피-음료",8,10,0,0,0,0,2
20233,"응봉동","슈퍼마켓",11,12,0,0,0,0,1
20233,"응봉동","미곡판매",2,2,0,0,0,0,0
20233,"응봉동","육류판매",4,4,0,0,0,0,0
20233,"응봉동","수산물판매",1,1,0,0,0,0,0
20233,"응봉동","청과상",4,4,0,0,0,0,0
20233,"응봉동","반찬가게",7,7,0,0,0,0,0
20233,"행당제1동","한식음식점",103,131,2,3,5,6,28
20233,"행당제1동","중식음식점",10,11,0,0,9,1,1
20233,"행당제1동","일식음식점",15,20,0,0,0,0,5
20233,"행당제1동","양식음식점",20,26,8,2,4,1,6
20233,"행당제1동","제과점",13,25,0,0,12,3,12
20233,"행당제1동","패스트푸드점",7,18,0,0,6,1,11
20233,"행당제1동","치킨전문점",6,19,5,1,11,2,13
20233,"행당제1동","분식전문점",36,42,7,3,0,0,6
20233,"행당제1동","호프-간이주점",17,18,6,1,0,0,1
20233,"행당제1동","커피-음료",37,54,7,4,7,4,17
20233,"행당제1동","슈퍼마켓",15,19,0,0,0,0,4
20233,"행당제1동","미곡판매",5,5,0,0,0,0,0
20233,"행당제1동","육류판매",35,35,0,0,0,0,0
20233,"행당제1동","수산물판매",8,8,0,0,0,0,0
20233,"행당제1동","청과상",6,6,17,1,0,0,0
20233,"행당제1동","반찬가게",17,17,6,1,0,0,0
20233,"행당제2동","한식음식점",14,17,0,0,6,1,3
20233,"행당제2동","중식음식점",1,3,0,0,0,0,2
20233,"행당제2동","일식음식점",2,2,0,0,50,1,0
20233,"행당제2동","양식음식점",2,2,0,0,0,0,0
20233,"행당제2동","제과점",6,9,0,0,11,1,3
20233,"행당제2동","패스트푸드점",3,6,17,1,17,1,3
20233,"행당제2동","치킨전문점",1,11,0,0,0,0,10
20233,"행당제2동","분식전문점",4,11,9,1,0,0,7
20233,"행당제2동","호프-간이주점",3,5,0,0,0,0,2
20233,"행당제2동","커피-음료",11,17,6,1,6,1,6
20233,"행당제2동","슈퍼마켓",4,7,0,0,0,0,3
20233,"행당제2동","미곡판매",1,1,0,0,0,0,0
20233,"행당제2동","육류판매",4,4,0,0,0,0,0
20233,"행당제2동","수산물판매",3,3,0,0,0,0,0
20233,"행당제2동","청과상",7,7,0,0,0,0,0
20233,"행당제2동","반찬가게",9,10,0,0,20,2,1
20234,"금호1가동","한식음식점",19,25,12,3,0,0,6
20234,"금호1가동","중식음식점",1,3,0,0,0,0,2
20234,"금호1가동","일식음식점",4,4,0,0,0,0,0
20234,"금호1가동","양식음식점",6,6,0,0,33,2,0
20234,"금호1가동","제과점",2,3,0,0,0,0,1
20234,"금호1가동","패스트푸드점",2,6,0,0,0,0,4
20234,"금호1가동","치킨전문점",3,6,17,1,17,1,3
20234,"금호1가동","분식전문점",9,11,0,0,18,2,2
20234,"금호1가동","호프-간이주점",9,9,22,2,11,1,0
20234,"금호1가동","커피-음료",14,18,0,0,0,0,4
20234,"금호1가동","슈퍼마켓",9,11,0,0,0,0,2
20234,"금호1가동","미곡판매",4,4,0,0,0,0,0
20234,"금호1가동","육류판매",5,5,0,0,0,0,0
20234,"금호1가동","수산물판매",3,3,0,0,0,0,0
20234,"금호1가동","청과상",7,7,0,0,0,0,0
20234,"금호1가동","반찬가게",4,4,0,0,0,0,0
20234,"금호2.3가동","한식음식점",102,116,4,5,4,5,14
20234,"금호2.3가동","중식음식점",6,7,0,0,0,0,1
20234,"금호2.3가동","일식음식점",5,6,0,0,0,0,1
20234,"금호2.3가동","양식음식점",15,16,0,0,13,2,1
20234,"금호2.3가동","제과점",8,11,0,0,0,0,3
20234,"금호2.3가동","패스트푸드점",2,12,25,3,0,0,10
20234,"금호2.3가동","치킨전문점",9,18,0,0,0,0,9
20234,"금호2.3가동","분식전문점",18,22,0,0,0,0,4
20234,"금호2.3가동","호프-간이주점",29,30,3,1,0,0,1
20234,"금호2.3가동","커피-음료",24,30,10,3,7,2,6
20234,"금호2.3가동","슈퍼마켓",16,21,10,2,0,0,5
20234,"금호2.3가동","미곡판매",3,3,0,0,0,0,0
20234,"금호2.3가동","육류판매",15,15,0,0,0,0,0
20234,"금호2.3가동","수산물판매",5,5,0,0,0,0,0
20234,"금호2.3가동","청과상",5,5,0,0,0,0,0
20234,"금호2.3가동","반찬가게",12,13,0,0,0,0,1
20234,"금호4가동","한식음식점",48,51,2,1,4,2,3
20234,"금호4가동","중식음식점",5,6,17,1,0,0,1
20234,"금호4가동","일식음식점",5,5,20,1,0,0,0
20234,"금호4가동","양식음식점",4,4,0,0,0,0,0
20234,"금호4가동","제과점",4,8,0,0,0,0,4
20234,"금호4가동","패스트푸드점",3,7,14,1,0,0,4
20234,"금호4가동","치킨전문점",1,7,0,0,0,0,6
20234,"금호4가동","분식전문점",7,13,8,1,0,0,6
20234,"금호4가동","호프-간이주점",20,20,5,1,0,0,0
20234,"금호4가동","커피-음료",18,26,0,0,8,2,8
20234,"금호4가동","슈퍼마켓",7,9,0,0,0,0,2
20234,"금호4가동","미곡판매",1,1,0,0,0,0,0
20234,"금호4가동","육류판매",3,3,0,0,0,0,0
20234,"금호4가동","수산물판매",1,1,0,0,0,0,0
20234,"금호4가동","청과상",7,7,0,0,14,1,0
20234,"금호4가동","반찬가게",3,3,0,0,0,0,0
20234,"마장동","한식음식점",120,125,2,2,3,4,5
20234,"마장동","중식음식점",5,5,0,0,0,0,0
20234,"마장동","일식음식점",3,3,0,0,0,0,0
20234,"마장동","양식음식점",4,5,0,0,0,0,1
20234,"마장동","제과점",2,4,0,0,0,0,2
20234,"마장동","패스트푸드점",4,6,0,0,0,0,2
20234,"마장동","치킨전문점",2,10,0,0,0,0,8
20234,"마장동","분식전문점",10,13,0,0,0,0,3
20234,"마장동","호프-간이주점",19,23,9,2,4,1,4
20234,"마장동","커피-음료",22,27,0,0,0,0,5
20234,"마장동","슈퍼마켓",28,31,3,1,3,1,3
20234,"마장동","미곡판매",2,2,0,0,0,0,0
20234,"마장동","육류판매",1634,1634,1,15,1,11,0
20234,"마장동","수산물판매",2,2,0,0,0,0,0
20234,"마장동","청과상",19,19,5,1,0,0,0
20234,"마장동","반찬가게",14,14,0,0,0,0,0
20234,"사근동","한식음식점",105,131,3,4,5,7,26
20234,"사근동","중식음식점",13,21,0,0,0,0,8
20234,"사근동","일식음식점",19,22,0,0,0,0,3
20234,"사근동","양식음식점",25,30,0,0,3,1,5
20234,"사근동","제과점",3,8,13,1,0,0,5
20234,"사근동","패스트푸드점",13,29,0,0,0,0,16
20234,"사근동","치킨전문점",9,19,0,0,0,0,10
20234,"사근동","분식전문점",20,33,12,4,3,1,13
20234,"사근동","호프-간이주점",56,73,6,4,1,1,17
20234,"사근동","커피-음료",65,92,1,1,1,1,27
20234,"사근동","슈퍼마켓",14,17,6,1,12,2,3
20234,"사근동","미곡판매",3,3,0,0,0,0,0
20234,"사근동","육류판매",4,4,0,0,0,0,0
20234,"사근동","청과상",1,1,0,0,0,0,0
20234,"사근동","반찬가게",5,5,0,0,0,0,0
20234,"성수1가제1동","한식음식점",67,73,3,2,1,1,6
20234,"성수1가제1동","중식음식점",11,13,8,1,0,0,2
20234,"성수1가제1동","일식음식점",13,14,7,1,0,0,1
20234,"성수1가제1동","양식음식점",47,50,2,1,0,0,3
20234,"성수1가제1동","제과점",18,20,5,1,5,1,2
20234,"성수1가제1동","패스트푸드점",12,16,6,1,0,0,4
20234,"성수1가제1동","치킨전문점",1,7,0,0,0,0,6
20234,"성수1가제1동","분식전문점",22,24,13,3,0,0,2
20234,"성수1가제1동","호프-간이주점",22,22,0,0,0,0,0
20234,"성수1가제1동","커피-음료",65,80,4,3,1,1,15
20234,"성수1가제1동","슈퍼마켓",10,19,11,2,0,0,9
20234,"성수1가제1동","미곡판매",3,3,0,0,0,0,0
20234,"성수1가제1동","육류판매",5,5,0,0,0,0,0
20234,"성수1가제1동","수산물판매",2,2,0,0,0,0,0
20234,"성수1가제1동","청과상",4,4,0,0,25,1,0
20234,"성수1가제1동","반찬가게",11,11,0,0,9,1,0
20234,"성수1가제2동","한식음식점",167,185,3,5,5,9,18
20234,"성수1가제2동","중식음식점",18,19,5,1,0,0,1
20234,"성수1가제2동","일식음식점",48,52,6,3,4,2,4
20234,"성수1가제2동","양식음식점",98,100,6,6,3,3,2
20234,"성수1가제2동","제과점",53,54,13,7,2,1,1
20234,"성수1가제2동","패스트푸드점",24,30,10,3,3,1,6
20234,"성수1가제2동","치킨전문점",4,12,0,0,0,0,8
20234,"성수1가제2동","분식전문점",21,29,7,2,0,0,8
20234,"성수1가제2동","호프-간이주점",53,63,8,5,5,3,10
20234,"성수1가제2동","커피-음료",194,221,2,5,5,11,27
20234,"성수1가제2동","슈퍼마켓",15,21,5,1,0,0,6
20234,"성수1가제2동","미곡판매",5,5,0,0,0,0,0
20234,"성수1가제2동","육류판매",11,11,0,0,9,1,0
20234,"성수1가제2동","수산물판매",4,4,0,0,0,0,0
20234,"성수1가제2동","청과상",4,4,0,0,0,0,0
20234,"성수1가제2동","반찬가게",37,41,5,2,0,0,4
20234,"성수2가제1동","한식음식점",143,157,3,4,3,4,14
20234,"성수2가제1동","중식음식점",10,11,0,0,0,0,1
20234,"성수2가제1동","일식음식점",19,20,20,4,10,2,1
20234,"성수2가제1동","양식음식점",53,56,11,6,2,1,3
20234,"성수2가제1동","제과점",28,30,0,0,3,1,2
20234,"성수2가제1동","패스트푸드점",20,24,0,0,13,3,4
20234,"성수2가제1동","치킨전문점",8,14,7,1,0,0,6
20234,"성수2가제1동","분식전문점",28,33,9,3,9,3,5
20234,"성수2가제1동","호프-간이주점",58,63,6,4,8,5,5
20234,"성수2가제1동","커피-음료",92,106,8,8,6,6,14
20234,"성수2가제1동","슈퍼마켓",19,23,0,0,4,1,4
20234,"성수2가제1동","미곡판매",9,9,0,0,0,0,0
20234,"성수2가제1동","육류판매",9,9,0,0,0,0,0
20234,"성수2가제1동","수산물판매",10,10,0,0,0,0,0
20234,"성수2가제1동","청과상",16,16,0,0,0,0,0
20234,"성수2가제1동","반찬가게",31,31,3,1,0,0,0
20234,"성수2가제3동","한식음식점",256,294,5,15,2,5,38
20234,"성수2가제3동","중식음식점",23,30,0,0,3,1,7
20234,"성수2가제3동","일식음식점",48,57,4,2,2,1,9
20234,"성수2가제3동","양식음식점",67,71,1,1,3,2,4
20234,"성수2가제3동","제과점",30,37,8,3,5,2,7
20234,"성수2가제3동","패스트푸드점",24,37,3,1,3,1,13
20234,"성수2가제3동","치킨전문점",4,11,0,0,0,0,7
20234,"성수2가제3동","분식전문점",28,34,6,2,3,1,6
20234,"성수2가제3동","호프-간이주점",59,70,1,1,1,1,11
20234,"성수2가제3동","커피-음료",160,196,6,12,3,6,36
20234,"성수2가제3동","슈퍼마켓",26,41,0,0,0,0,15
20234,"성수2가제3동","미곡판매",5,5,0,0,0,0,0
20234,"성수2가제3동","육류판매",18,18,0,0,6,1,0
20234,"성수2가제3동","수산물판매",2,2,0,0,0,0,0
20234,"성수2가제3동","청과상",13,13,0,0,0,0,0
20234,"성수2가제3동","반찬가게",74,76,1,1,0,0,2
20234,"송정동","한식음식점",38,40,3,1,5,2,2
20234,"송정동","중식음식점",2,2,0,0,0,0,0
20234,"송정동","일식음식점",2,2,0,0,0,0,0
20234,"송정동","양식음식점",6,6,33,2,0,0,0
20234,"송정동","제과점",6,6,0,0,0,0,0
20234,"송정동","패스트푸드점",4,5,0,0,0,0,1
20234,"송정동","치킨전문점",3,4,0,0,0,0,1
20234,"송정동","분식전문점",6,6,0,0,0,0,0
20234,"송정동","호프-간이주점",5,5,0,0,0,0,0
20234,"송정동","커피-음료",21,23,0,0,9,2,2
20234,"송정동","슈퍼마켓",9,11,0,0,0,0,2
20234,"송정동","미곡판매",2,2,0,0,0,0,0
20234,"송정동","육류판매",6,6,0,0,0,0,0
20234,"송정동","수산물판매",2,2,0,0,0,0,0
20234,"송정동","청과상",4,4,0,0,0,0,0
20234,"송정동","반찬가게",2,2,0,0,0,0,0
20234,"옥수동","한식음식점",54,59,3,2,3,2,5
20234,"옥수동","중식음식점",7,8,0,0,0,0,1
20234,"옥수동","일식음식점",8,8,13,1,0,0,0
20234,"옥수동","양식음식점",9,9,0,0,0,0,0
20234,"옥수동","제과점",10,14,0,0,0,0,4
20234,"옥수동","패스트푸드점",8,12,0,0,0,0,4
20234,"옥수동","치킨전문점",3,9,0,0,11,1,6
20234,"옥수동","분식전문점",10,16,0,0,0,0,6
20234,"옥수동","호프-간이주점",8,9,0,0,0,0,1
20234,"옥수동","커피-음료",23,29,7,2,0,0,6
20234,"옥수동","슈퍼마켓",8,15,0,0,0,0,7
20234,"옥수동","미곡판매",2,2,0,0,0,0,0
20234,"옥수동","육류판매",8,9,0,0,0,0,1
20234,"옥수동","수산물판매",3,3,0,0,0,0,0
20234,"옥수동","청과상",4,4,0,0,0,0,0
20234,"옥수동","반찬가게",11,13,0,0,0,0,2
20234,"왕십리도선동","한식음식점",180,224,5,12,5,11,44
20234,"왕십리도선동","중식음식점",15,18,6,1,6,1,3
20234,"왕십리도선동","일식음식점",17,20,0,0,15,3,3
20234,"왕십리도선동","양식음식점",22,26,8,2,0,0,4
20234,"왕십리도선동","제과점",17,25,0,0,0,0,8
20234,"왕십리도선동","패스트푸드점",11,24,0,0,0,0,13
20234,"왕십리도선동","치킨전문점",4,23,9,2,4,1,19
20234,"왕십리도선동","분식전문점",44,61,5,3,3,2,17
20234,"왕십리도선동","호프-간이주점",50,53,6,3,0,0,3
20234,"왕십리도선동","커피-음료",44,71,1,1,7,5,27
20234,"왕십리도선동","슈퍼마켓",27,35,3,1,0,0,8
20234,"왕십리도선동","미곡판매",9,9,0,0,0,0,0
20234,"왕십리도선동","육류판매",58,58,0,0,2,1,0
20234,"왕십리도선동","수산물판매",8,8,0,0,0,0,0
20234,"왕십리도선동","청과상",17,17,0,0,0,0,0
20234,"왕십리도선동","반찬가게",27,29,7,2,0,0,2
20234,"왕십리제2동","한식음식점",47,50,6,3,4,2,3
20234,"왕십리제2동","중식음식점",5,7,0,0,0,0,2
20234,"왕십리제2동","일식음식점",3,3,0,0,0,0,0
20234,"왕십리제2동","양식음식점",6,8,13,1,0,0,2
20234,"왕십리제2동","제과점",7,8,0,0,13,1,1
20234,"왕십리제2동","패스트푸드점",4,12,8,1,0,0,8
20234,"왕십리제2동","치킨전문점",7,12,0,0,0,0,5
20234,"왕십리제2동","분식전문점",12,15,13,2,0,0,3
20234,"왕십리제2동","호프-간이주점",6,7,14,1,0,0,1
20234,"왕십리제2동","커피-음료",23,26,8,2,0,0,3
20234,"왕십리제2동","슈퍼마켓",10,15,0,0,7,1,5
20234,"왕십리제2동","미곡판매",3,3,0,0,0,0,0
20234,"왕십리제2동","육류판매",7,7,14,1,0,0,0
20234,"왕십리제2동","수산물판매",2,2,0,0,0,0,0
20234,"왕십리제2동","청과상",7,7,0,0,0,0,0
20234,"왕십리제2동","반찬가게",3,3,0,0,67,2,0
20234,"용답동","한식음식점",105,115,2,2,2,2,10
20234,"용답동","중식음식점",8,8,0,0,0,0,0
20234,"용답동","일식음식점",9,9,0,0,0,0,0
20234,"용답동","양식음식점",7,8,13,1,0,0,1
20234,"용답동","제과점",4,5,0,0,0,0,1
20234,"용답동","패스트푸드점",3,5,0,0,0,0,2
20234,"용답동","치킨전문점",2,8,0,0,0,0,6
20234,"용답동","분식전문점",15,22,14,3,0,0,7
20234,"용답동","호프-간이주점",24,27,4,1,4,1,3
20234,"용답동","커피-음료",30,41,5,2,5,2,11
20234,"용답동","슈퍼마켓",26,27,0,0,7,2,1
20234,"용답동","미곡판매",4,4,0,0,0,0,0
20234,"용답동","육류판매",22,22,0,0,5,1,0
20234,"용답동","수산물판매",5,5,0,0,0,0,0
20234,"용답동","청과상",11,11,9,1,0,0,0
20234,"용답동","반찬가게",9,10,10,1,0,0,1
20234,"응봉동","한식음식점",9,9,0,0,0,0,0
20234,"응봉동","중식음식점",1,1,0,0,0,0,0
20234,"응봉동","양식음식점",3,3,0,0,0,0,0
20234,"응봉동","제과점",1,2,0,0,0,0,1
20234,"응봉동","패스트푸드점",0,1,0,0,0,0,1
20234,"응봉동","치킨전문점",1,7,14,1,0,0,6
20234,"응봉동","분식전문점",5,5,20,1,0,0,0
20234,"응봉동","호프-간이주점",0,1,0,0,0,0,1
20234,"응봉동","커피-음료",7,9,0,0,11,1,2
20234,"응봉동","슈퍼마켓",11,12,0,0,0,0,1
20234,"응봉동","미곡판매",2,2,0,0,0,0,0
20234,"응봉동","육류판매",4,4,0,0,0,0,0
20234,"응봉동","수산물판매",1,1,0,0,0,0,0
20234,"응봉동","청과상",4,4,0,0,0,0,0
20234,"응봉동","반찬가게",6,6,0,0,17,1,0
20234,"행당제1동","한식음식점",105,131,3,4,3,4,26
20234,"행당제1동","중식음식점",10,11,9,1,9,1,1
20234,"행당제1동","일식음식점",15,20,0,0,0,0,5
20234,"행당제1동","양식음식점",22,29,10,3,0,0,7
20234,"행당제1동","제과점",13,25,0,0,0,0,12
20234,"행당제1동","패스트푸드점",7,19,5,1,0,0,12
20234,"행당제1동","치킨전문점",7,19,5,1,5,1,12
20234,"행당제1동","분식전문점",33,40,8,3,13,5,7
20234,"행당제1동","호프-간이주점",17,18,0,0,0,0,1
20234,"행당제1동","커피-음료",35,53,8,4,9,5,18
20234,"행당제1동","슈퍼마켓",16,20,5,1,0,0,4
20234,"행당제1동","미곡판매",5,5,0,0,0,0,0
20234,"행당제1동","육류판매",35,35,0,0,0,0,0
20234,"행당제1동","수산물판매",9,9,11,1,0,0,0
20234,"행당제1동","청과상",5,5,0,0,20,1,0
20234,"행당제1동","반찬가게",17,17,0,0,0,0,0
20234,"행당제2동","한식음식점",13,16,0,0,6,1,3
20234,"행당제2동","중식음식점",1,3,0,0,0,0,2
20234,"행당제2동","일식음식점",2,2,0,0,0,0,0
20234,"행당제2동","양식음식점",2,2,0,0,0,0,0
20234,"행당제2동","제과점",6,9,0,0,0,0,3
20234,"행당제2동","패스트푸드점",3,6,0,0,0,0,3
20234,"행당제2동","치킨전문점",1,11,0,0,0,0,10
20234,"행당제2동","분식전문점",4,11,0,0,0,0,7
20234,"행당제2동","호프-간이주점",3,5,0,0,0,0,2
20234,"행당제2동","커피-음료",11,17,0,0,0,0,6
20234,"행당제2동","슈퍼마켓",4,7,0,0,0,0,3
20234,"행당제2동","미곡판매",1,1,0,0,0,0,0
20234,"행당제2동","육류판매",4,4,0,0,0,0,0
20234,"행당제2동","수산물판매",3,3,0,0,0,0,0
20234,"행당제2동","청과상",7,7,0,0,0,0,0
20234,"행당제2동","반찬가게",9,10,0,0,0,0,1
20241,"금호1가동","미곡판매",4,4,0,0,0,0,0
20241,"금호1가동","반찬가게",3,3,0,0,33,1,0
20241,"금호1가동","분식전문점",9,11,0,0,0,0,2
20241,"금호1가동","수산물판매",3,3,0,0,0,0,0
20241,"금호1가동","슈퍼마켓",10,12,8,1,0,0,2
20241,"금호1가동","양식음식점",6,6,0,0,0,0,0
20241,"금호1가동","육류판매",5,5,0,0,0,0,0
20241,"금호1가동","일식음식점",4,4,0,0,0,0,0
20241,"금호1가동","제과점",2,3,0,0,0,0,1
20241,"금호1가동","중식음식점",1,3,0,0,0,0,2
20241,"금호1가동","청과상",7,7,0,0,0,0,0
20241,"금호1가동","치킨전문점",3,6,0,0,0,0,3
20241,"금호1가동","커피-음료",13,17,0,0,6,1,4
20241,"금호1가동","패스트푸드점",2,6,0,0,0,0,4
20241,"금호1가동","한식음식점",20,26,4,1,0,0,6
20241,"금호1가동","호프-간이주점",7,7,0,0,29,2,0
20241,"금호2.3가동","미곡판매",3,3,0,0,0,0,0
20241,"금호2.3가동","반찬가게",11,12,0,0,8,1,1
20241,"금호2.3가동","분식전문점",19,23,9,2,4,1,4
20241,"금호2.3가동","수산물판매",5,5,0,0,0,0,0
20241,"금호2.3가동","슈퍼마켓",16,22,9,2,5,1,6
20241,"금호2.3가동","양식음식점",15,16,0,0,0,0,1
20241,"금호2.3가동","육류판매",15,15,0,0,0,0,0
20241,"금호2.3가동","일식음식점",5,6,0,0,0,0,1
20241,"금호2.3가동","제과점",7,10,0,0,10,1,3
20241,"금호2.3가동","중식음식점",6,7,0,0,0,0,1
20241,"금호2.3가동","청과상",5,5,0,0,0,0,0
20241,"금호2.3가동","치킨전문점",10,19,11,2,5,1,9
20241,"금호2.3가동","커피-음료",26,32,9,3,3,1,6
20241,"금호2.3가동","패스트푸드점",2,12,0,0,0,0,10
20241,"금호2.3가동","한식음식점",102,115,4,4,4,5,13
20241,"금호2.3가동","호프-간이주점",29,30,0,0,0,0,1
20241,"금호4가동","미곡판매",1,1,0,0,0,0,0
20241,"금호4가동","반찬가게",3,3,0,0,0,0,0
20241,"금호4가동","분식전문점",7,13,0,0,0,0,6
20241,"금호4가동","수산물판매",0,0,0,0,0,1,0
20241,"금호4가동","슈퍼마켓",7,9,0,0,0,0,2
20241,"금호4가동","양식음식점",4,4,0,0,0,0,0
20241,"금호4가동","육류판매",3,3,0,0,0,0,0
20241,"금호4가동","일식음식점",5,5,0,0,0,0,0
20241,"금호4가동","제과점",5,9,11,1,0,0,4
20241,"금호4가동","중식음식점",4,5,0,0,20,1,1
20241,"금호4가동","청과상",6,6,0,0,17,1,0
20241,"금호4가동","치킨전문점",1,7,0,0,0,0,6
20241,"금호4가동","커피-음료",19,27,4,1,0,0,8
20241,"금호4가동","패스트푸드점",3,8,13,1,0,0,5
20241,"금호4가동","한식음식점",46,49,0,0,4,2,3
20241,"금호4가동","호프-간이주점",20,20,0,0,0,0,0
20241,"마장동","미곡판매",2,2,0,0,0,0,0
20241,"마장동","반찬가게",15,15,7,1,0,0,0
20241,"마장동","분식전문점",10,13,0,0,0,0,3
20241,"마장동","수산물판매",2,2,0,0,0,0,0
20241,"마장동","슈퍼마켓",27,30,3,1,7,2,3
20241,"마장동","양식음식점",4,5,0,0,0,0,1
20241,"마장동","육류판매",1614,1614,1,16,2,36,0
20241,"마장동","일식음식점",4,4,25,1,0,0,0
20241,"마장동","제과점",2,4,0,0,0,0,2
20241,"마장동","중식음식점",5,5,0,0,0,0,0
20241,"마장동","청과상",25,25,24,6,0,0,0
20241,"마장동","치킨전문점",2,11,9,1,0,0,9
20241,"마장동","커피-음료",24,29,7,2,0,0,5
20241,"마장동","패스트푸드점",4,6,0,0,0,0,2
20241,"마장동","한식음식점",121,126,3,4,2,3,5
20241,"마장동","호프-간이주점",19,23,0,0,0,0,4
20241,"사근동","미곡판매",3,3,0,0,0,0,0
20241,"사근동","반찬가게",5,5,20,1,20,1,0
20241,"사근동","분식전문점",22,35,6,2,0,0,13
20241,"사근동","슈퍼마켓",15,18,11,2,6,1,3
20241,"사근동","양식음식점",23,28,4,1,11,3,5
20241,"사근동","육류판매",4,4,0,0,0,0,0
20241,"사근동","일식음식점",19,22,14,3,14,3,3
20241,"사근동","제과점",5,10,20,2,0,0,5
20241,"사근동","중식음식점",16,24,13,3,0,0,8
20241,"사근동","청과상",1,1,0,0,0,0,0
20241,"사근동","치킨전문점",9,19,0,0,0,0,10
20241,"사근동","커피-음료",68,95,6,6,3,3,27
20241,"사근동","패스트푸드점",12,27,4,1,11,3,15
20241,"사근동","한식음식점",113,141,8,11,1,1,28
20241,"사근동","호프-간이주점",53,69,0,0,6,4,16
20241,"성수1가제1동","미곡판매",3,3,0,0,0,0,0
20241,"성수1가제1동","반찬가게",12,12,8,1,0,0,0
20241,"성수1가제1동","분식전문점",22,23,4,1,9,2,1
20241,"성수1가제1동","수산물판매",2,2,0,0,0,0,0
20241,"성수1가제1동","슈퍼마켓",10,19,0,0,0,0,9
20241,"성수1가제1동","양식음식점",46,49,2,1,4,2,3
20241,"성수1가제1동","육류판매",5,5,0,0,0,0,0
20241,"성수1가제1동","일식음식점",14,15,7,1,0,0,1
20241,"성수1가제1동","제과점",19,20,5,1,5,1,1
20241,"성수1가제1동","중식음식점",11,13,0,0,0,0,2
20241,"성수1가제1동","청과상",4,4,0,0,0,0,0
20241,"성수1가제1동","치킨전문점",1,7,0,0,0,0,6
20241,"성수1가제1동","커피-음료",64,79,3,2,4,3,15
20241,"성수1가제1동","패스트푸드점",11,16,13,2,13,2,5
20241,"성수1가제1동","한식음식점",72,78,8,6,1,1,6
20241,"성수1가제1동","호프-간이주점",22,22,5,1,5,1,0
20241,"성수1가제2동","미곡판매",4,4,0,0,25,1,0
20241,"성수1가제2동","반찬가게",37,41,0,0,0,0,4
20241,"성수1가제2동","분식전문점",23,31,7,2,0,0,8
20241,"성수1가제2동","수산물판매",4,4,0,0,0,0,0
20241,"성수1가제2동","슈퍼마켓",16,22,5,1,0,0,6
20241,"성수1가제2동","양식음식점",103,105,9,9,4,4,2
20241,"성수1가제2동","육류판매",11,11,0,0,0,0,0
20241,"성수1가제2동","일식음식점",43,48,4,2,13,6,5
20241,"성수1가제2동","제과점",50,51,4,2,10,5,1
20241,"성수1가제2동","중식음식점",18,19,0,0,0,0,1
20241,"성수1가제2동","청과상",4,4,0,0,0,0,0
20241,"성수1가제2동","치킨전문점",4,12,0,0,0,0,8
20241,"성수1가제2동","커피-음료",199,226,4,10,2,5,27
20241,"성수1가제2동","패스트푸드점",23,29,7,2,10,3,6
20241,"성수1가제2동","한식음식점",168,185,3,6,3,6,17
20241,"성수1가제2동","호프-간이주점",54,65,3,2,0,0,11
20241,"성수2가제1동","미곡판매",9,9,0,0,0,0,0
20241,"성수2가제1동","반찬가게",31,31,0,0,0,0,0
20241,"성수2가제1동","분식전문점",29,34,6,2,3,1,5
20241,"성수2가제1동","수산물판매",10,10,0,0,0,0,0
20241,"성수2가제1동","슈퍼마켓",17,21,0,0,10,2,4
20241,"성수2가제1동","양식음식점",56,59,9,5,3,2,3
20241,"성수2가제1동","육류판매",9,9,0,0,0,0,0
20241,"성수2가제1동","일식음식점",20,21,5,1,0,0,1
20241,"성수2가제1동","제과점",28,30,7,2,7,2,2
20241,"성수2가제1동","중식음식점",10,11,0,0,0,0,1
20241,"성수2가제1동","청과상",16,16,0,0,0,0,0
20241,"성수2가제1동","치킨전문점",8,14,0,0,0,0,6
20241,"성수2가제1동","커피-음료",91,105,2,2,3,3,14
20241,"성수2가제1동","패스트푸드점",21,24,4,1,4,1,3
20241,"성수2가제1동","한식음식점",145,159,4,6,3,4,14
20241,"성수2가제1동","호프-간이주점",57,62,2,1,3,2,5
20241,"성수2가제3동","미곡판매",5,5,0,0,0,0,0
20241,"성수2가제3동","반찬가게",75,78,4,3,1,1,3
20241,"성수2가제3동","분식전문점",25,31,7,2,16,5,6
20241,"성수2가제3동","수산물판매",2,2,0,0,0,0,0
20241,"성수2가제3동","슈퍼마켓",26,40,0,0,3,1,14
20241,"성수2가제3동","양식음식점",63,67,8,5,13,9,4
20241,"성수2가제3동","육류판매",18,18,0,0,0,0,0
20241,"성수2가제3동","일식음식점",52,60,10,6,5,3,8
20241,"성수2가제3동","제과점",32,39,10,4,5,2,7
20241,"성수2가제3동","중식음식점",23,30,0,0,0,0,7
20241,"성수2가제3동","청과상",13,13,0,0,0,0,0
20241,"성수2가제3동","치킨전문점",4,11,0,0,0,0,7
20241,"성수2가제3동","커피-음료",160,198,8,15,7,13,38
20241,"성수2가제3동","패스트푸드점",25,38,5,2,3,1,13
20241,"성수2가제3동","한식음식점",259,296,4,13,4,11,37
20241,"성수2가제3동","호프-간이주점",58,68,2,1,4,3,10
20241,"송정동","미곡판매",2,2,0,0,0,0,0
20241,"송정동","반찬가게",2,2,0,0,0,0,0
20241,"송정동","분식전문점",6,6,0,0,0,0,0
20241,"송정동","수산물판매",2,2,0,0,0,0,0
20241,"송정동","슈퍼마켓",10,12,8,1,0,0,2
20241,"송정동","양식음식점",6,6,0,0,0,0,0
20241,"송정동","육류판매",6,6,0,0,0,0,0
20241,"송정동","일식음식점",2,2,0,0,0,0,0
20241,"송정동","제과점",6,6,0,0,0,0,0
20241,"송정동","중식음식점",2,2,0,0,0,0,0
20241,"송정동","청과상",4,4,0,0,0,0,0
20241,"송정동","치킨전문점",3,4,0,0,0,0,1
20241,"송정동","커피-음료",21,23,4,1,4,1,2
20241,"송정동","패스트푸드점",3,4,0,0,25,1,1
20241,"송정동","한식음식점",39,41,5,2,2,1,2
20241,"송정동","호프-간이주점",5,5,0,0,0,0,0
20241,"옥수동","미곡판매",2,2,0,0,0,0,0
20241,"옥수동","반찬가게",11,13,0,0,0,0,2
20241,"옥수동","분식전문점",10,16,13,2,13,2,6
20241,"옥수동","수산물판매",3,3,0,0,0,0,0
20241,"옥수동","슈퍼마켓",9,16,6,1,0,0,7
20241,"옥수동","양식음식점",9,9,0,0,0,0,0
20241,"옥수동","육류판매",8,9,0,0,0,0,1
20241,"옥수동","일식음식점",7,8,25,2,25,2,1
20241,"옥수동","제과점",11,15,7,1,0,0,4
20241,"옥수동","중식음식점",7,8,0,0,0,0,1
20241,"옥수동","청과상",4,4,0,0,0,0,0
20241,"옥수동","치킨전문점",3,9,0,0,0,0,6
20241,"옥수동","커피-음료",19,25,0,0,16,4,6
20241,"옥수동","패스트푸드점",8,12,0,0,0,0,4
20241,"옥수동","한식음식점",57,62,8,5,3,2,5
20241,"옥수동","호프-간이주점",8,9,0,0,0,0,1
20241,"왕십리도선동","미곡판매",9,9,0,0,0,0,0
20241,"왕십리도선동","반찬가게",26,28,0,0,4,1,2
20241,"왕십리도선동","분식전문점",44,63,5,3,2,1,19
20241,"왕십리도선동","수산물판매",8,8,0,0,0,0,0
20241,"왕십리도선동","슈퍼마켓",24,32,0,0,9,3,8
20241,"왕십리도선동","양식음식점",21,25,8,2,12,3,4
20241,"왕십리도선동","육류판매",55,55,0,0,6,3,0
20241,"왕십리도선동","일식음식점",18,21,5,1,0,0,3
20241,"왕십리도선동","제과점",18,25,4,1,4,1,7
20241,"왕십리도선동","중식음식점",15,18,6,1,6,1,3
20241,"왕십리도선동","청과상",18,18,11,2,6,1,0
20241,"왕십리도선동","치킨전문점",5,22,5,1,9,2,17
20241,"왕십리도선동","커피-음료",45,73,4,3,1,1,28
20241,"왕십리도선동","패스트푸드점",11,24,4,1,4,1,13
20241,"왕십리도선동","한식음식점",184,227,4,8,2,5,43
20241,"왕십리도선동","호프-간이주점",47,50,4,2,10,5,3
20241,"왕십리제2동","미곡판매",3,3,0,0,0,0,0
20241,"왕십리제2동","반찬가게",3,3,0,0,0,0,0
20241,"왕십리제2동","분식전문점",12,15,0,0,0,0,3
20241,"왕십리제2동","수산물판매",2,2,0,0,0,0,0
20241,"왕십리제2동","슈퍼마켓",10,15,0,0,0,0,5
20241,"왕십리제2동","양식음식점",5,8,13,1,13,1,3
20241,"왕십리제2동","육류판매",7,7,0,0,0,0,0
20241,"왕십리제2동","일식음식점",4,4,25,1,0,0,0
20241,"왕십리제2동","제과점",8,9,11,1,0,0,1
20241,"왕십리제2동","중식음식점",4,6,0,0,17,1,2
20241,"왕십리제2동","청과상",7,7,0,0,0,0,0
20241,"왕십리제2동","치킨전문점",7,12,17,2,17,2,5
20241,"왕십리제2동","커피-음료",22,25,0,0,4,1,3
20241,"왕십리제2동","패스트푸드점",5,13,15,2,8,1,8
20241,"왕십리제2동","한식음식점",46,49,0,0,2,1,3
20241,"왕십리제2동","호프-간이주점",6,7,0,0,0,0,1
20241,"용답동","미곡판매",4,4,0,0,0,0,0
20241,"용답동","반찬가게",9,10,0,0,0,0,1
20241,"용답동","분식전문점",13,20,0,0,10,2,7
20241,"용답동","수산물판매",5,5,0,0,0,0,0
20241,"용답동","슈퍼마켓",26,27,0,0,0,0,1
20241,"용답동","양식음식점",8,9,11,1,0,0,1
20241,"용답동","육류판매",22,22,0,0,0,0,0
20241,"용답동","일식음식점",9,9,0,0,0,0,0
20241,"용답동","제과점",4,5,0,0,0,0,1
20241,"용답동","중식음식점",8,8,0,0,0,0,0
20241,"용답동","청과상",10,10,0,0,10,1,0
20241,"용답동","치킨전문점",2,8,0,0,0,0,6
20241,"용답동","커피-음료",29,40,3,1,5,2,11
20241,"용답동","패스트푸드점",2,4,0,0,25,1,2
20241,"용답동","한식음식점",108,118,5,6,3,3,10
20241,"용답동","호프-간이주점",22,25,0,0,8,2,3
20241,"응봉동","미곡판매",2,2,0,0,0,0,0
20241,"응봉동","반찬가게",6,6,0,0,0,0,0
20241,"응봉동","분식전문점",5,5,0,0,0,0,0
20241,"응봉동","수산물판매",1,1,0,0,0,0,0
20241,"응봉동","슈퍼마켓",11,12,0,0,0,0,1
20241,"응봉동","양식음식점",3,3,0,0,0,0,0
20241,"응봉동","육류판매",4,4,0,0,0,0,0
20241,"응봉동","제과점",2,3,33,1,0,0,1
20241,"응봉동","중식음식점",1,1,0,0,0,0,0
20241,"응봉동","청과상",2,2,0,0,100,2,0
20241,"응봉동","치킨전문점",1,6,0,0,17,1,5
20241,"응봉동","커피-음료",7,9,0,0,0,0,2
20241,"응봉동","패스트푸드점",0,1,0,0,0,0,1
20241,"응봉동","한식음식점",9,9,0,0,0,0,0
20241,"응봉동","호프-간이주점",0,1,0,0,0,0,1
20241,"행당제1동","미곡판매",5,5,0,0,0,0,0
20241,"행당제1동","반찬가게",17,19,16,3,5,1,2
20241,"행당제1동","분식전문점",37,46,13,6,0,0,9
20241,"행당제1동","수산물판매",9,9,0,0,0,0,0
20241,"행당제1동","슈퍼마켓",15,20,10,2,10,2,5
20241,"행당제1동","양식음식점",25,32,9,3,0,0,7
20241,"행당제1동","육류판매",32,32,3,1,13,4,0
20241,"행당제1동","일식음식점",15,21,5,1,0,0,6
20241,"행당제1동","제과점",11,24,8,2,13,3,13
20241,"행당제1동","중식음식점",10,11,0,0,0,0,1
20241,"행당제1동","청과상",5,5,0,0,0,0,0
20241,"행당제1동","치킨전문점",6,19,5,1,5,1,13
20241,"행당제1동","커피-음료",36,53,4,2,4,2,17
20241,"행당제1동","패스트푸드점",7,18,0,0,6,1,11
20241,"행당제1동","한식음식점",113,138,9,13,4,6,25
20241,"행당제1동","호프-간이주점",17,18,0,0,0,0,1
20241,"행당제2동","미곡판매",1,1,0,0,0,0,0
20241,"행당제2동","반찬가게",10,11,9,1,0,0,1
20241,"행당제2동","분식전문점",6,13,15,2,0,0,7
20241,"행당제2동","수산물판매",3,3,0,0,0,0,0
20241,"행당제2동","슈퍼마켓",4,7,0,0,0,0,3
20241,"행당제2동","양식음식점",2,2,0,0,0,0,0
20241,"행당제2동","육류판매",4,4,0,0,0,0,0
20241,"행당제2동","일식음식점",2,2,0,0,0,0,0
20241,"행당제2동","제과점",5,10,20,2,10,1,5
20241,"행당제2동","중식음식점",1,3,33,1,33,1,2
20241,"행당제2동","청과상",7,7,0,0,0,0,0
20241,"행당제2동","치킨전문점",1,11,0,0,0,0,10
20241,"행당제2동","커피-음료",11,16,0,0,6,1,5
20241,"행당제2동","패스트푸드점",3,6,17,1,17,1,3
20241,"행당제2동","한식음식점",15,18,11,2,0,0,3
20241,"행당제2동","호프-간이주점",3,5,0,0,0,0,2
20242,"금호1가동","미곡판매",4,4,0,0,0,0,0
20242,"금호1가동","반찬가게",3,3,0,0,0,0,0
20242,"금호1가동","분식전문점",7,9,0,0,22,2,2
20242,"금호1가동","수산물판매",3,3,0,0,0,0,0
20242,"금호1가동","슈퍼마켓",10,12,0,0,0,0,2
20242,"금호1가동","양식음식점",6,6,0,0,0,0,0
20242,"금호1가동","육류판매",5,5,0,0,0,0,0
20242,"금호1가동","일식음식점",3,3,0,0,33,1,0
20242,"금호1가동","제과점",2,4,25,1,0,0,2
20242,"금호1가동","중식음식점",1,3,0,0,0,0,2
20242,"금호1가동","청과상",7,7,0,0,0,0,0
20242,"금호1가동","치킨전문점",3,6,17,1,17,1,3
20242,"금호1가동","커피-음료",13,17,0,0,0,0,4
20242,"금호1가동","패스트푸드점",2,6,0,0,0,0,4
20242,"금호1가동","한식음식점",22,27,7,2,4,1,5
20242,"금호1가동","호프-간이주점",8,8,13,1,0,0,0
20242,"금호2.3가동","미곡판매",3,3,0,0,0,0,0
20242,"금호2.3가동","반찬가게",12,13,8,1,0,0,1
20242,"금호2.3가동","분식전문점",19,23,0,0,0,0,4
20242,"금호2.3가동","수산물판매",5,5,0,0,0,0,0
20242,"금호2.3가동","슈퍼마켓",17,23,4,1,0,0,6
20242,"금호2.3가동","양식음식점",17,18,17,3,6,1,1
20242,"금호2.3가동","육류판매",15,15,0,0,0,0,0
20242,"금호2.3가동","일식음식점",6,7,14,1,0,0,1
20242,"금호2.3가동","제과점",7,10,10,1,10,1,3
20242,"금호2.3가동","중식음식점",5,6,0,0,17,1,1
20242,"금호2.3가동","청과상",5,5,0,0,0,0,0
20242,"금호2.3가동","치킨전문점",9,18,0,0,6,1,9
20242,"금호2.3가동","커피-음료",27,34,6,2,0,0,7
20242,"금호2.3가동","패스트푸드점",2,12,0,0,0,0,10
20242,"금호2.3가동","한식음식점",103,115,2,2,2,2,12
20242,"금호2.3가동","호프-간이주점",29,30,0,0,0,0,1
20242,"금호4가동","미곡판매",1,1,0,0,0,0,0
20242,"금호4가동","반찬가게",4,4,25,1,0,0,0
20242,"금호4가동","분식전문점",7,13,0,0,0,0,6
20242,"금호4가동","수산물판매",0,0,0,0,0,0,0
20242,"금호4가동","슈퍼마켓",7,9,0,0,0,0,2
20242,"금호4가동","양식음식점",4,4,0,0,0,0,0
20242,"금호4가동","육류판매",3,3,0,0,0,0,0
20242,"금호4가동","일식음식점",6,6,17,1,0,0,0
20242,"금호4가동","제과점",5,7,14,1,43,3,2
20242,"금호4가동","중식음식점",4,5,0,0,0,0,1
20242,"금호4가동","청과상",5,5,0,0,20,1,0
20242,"금호4가동","치킨전문점",1,7,0,0,0,0,6
20242,"금호4가동","커피-음료",15,23,4,1,22,5,8
20242,"금호4가동","패스트푸드점",3,8,0,0,0,0,5
20242,"금호4가동","한식음식점",47,50,2,1,0,0,3
20242,"금호4가동","호프-간이주점",20,20,0,0,0,0,0
20242,"마장동","미곡판매",2,2,0,0,0,0,0
20242,"마장동","반찬가게",16,16,6,1,0,0,0
20242,"마장동","분식전문점",10,13,0,0,0,0,3
20242,"마장동","수산물판매",2,2,0,0,0,0,0
20242,"마장동","슈퍼마켓",26,29,0,0,3,1,3
20242,"마장동","양식음식점",4,5,0,0,0,0,1
20242,"마장동","육류판매",1592,1592,0,6,2,28,0
20242,"마장동","일식음식점",5,5,20,1,0,0,0
20242,"마장동","제과점",2,4,0,0,0,0,2
20242,"마장동","중식음식점",5,5,0,0,0,0,0
20242,"마장동","청과상",30,30,17,5,0,0,0
20242,"마장동","치킨전문점",2,9,0,0,22,2,7
20242,"마장동","커피-음료",24,29,0,0,0,0,5
20242,"마장동","패스트푸드점",3,5,0,0,20,1,2
20242,"마장동","한식음식점",120,124,1,1,2,3,4
20242,"마장동","호프-간이주점",19,23,0,0,0,0,4
20242,"사근동","미곡판매",3,3,0,0,0,0,0
20242,"사근동","반찬가게",5,5,0,0,0,0,0
20242,"사근동","분식전문점",21,33,6,2,12,4,12
20242,"사근동","슈퍼마켓",14,17,0,0,6,1,3
20242,"사근동","양식음식점",22,26,0,0,8,2,4
20242,"사근동","육류판매",4,4,0,0,0,0,0
20242,"사근동","일식음식점",20,24,8,2,0,0,4
20242,"사근동","제과점",6,11,9,1,0,0,5
20242,"사근동","중식음식점",15,23,0,0,4,1,8
20242,"사근동","청과상",1,1,0,0,0,0,0
20242,"사근동","치킨전문점",9,19,0,0,0,0,10
20242,"사근동","커피-음료",62,88,1,1,9,8,26
20242,"사근동","패스트푸드점",11,26,0,0,4,1,15
20242,"사근동","한식음식점",119,148,5,7,0,0,29
20242,"사근동","호프-간이주점",52,67,9,6,12,8,15
20242,"성수1가제1동","미곡판매",3,3,0,0,0,0,0
20242,"성수1가제1동","반찬가게",12,12,0,0,0,0,0
20242,"성수1가제1동","분식전문점",19,20,0,0,15,3,1
20242,"성수1가제1동","수산물판매",1,1,0,0,100,1,0
20242,"성수1가제1동","슈퍼마켓",9,18,0,0,6,1,9
20242,"성수1가제1동","양식음식점",47,49,6,3,6,3,2
20242,"성수1가제1동","육류판매",5,5,0,0,0,0,0
20242,"성수1가제1동","일식음식점",15,16,6,1,0,0,1
20242,"성수1가제1동","제과점",20,21,10,2,5,1,1
20242,"성수1가제1동","중식음식점",11,13,0,0,0,0,2
20242,"성수1가제1동","청과상",4,4,0,0,0,0,0
20242,"성수1가제1동","치킨전문점",1,7,0,0,0,0,6
20242,"성수1가제1동","커피-음료",64,80,4,3,3,2,16
20242,"성수1가제1동","패스트푸드점",11,16,0,0,0,0,5
20242,"성수1가제1동","한식음식점",74,80,6,5,4,3,6
20242,"성수1가제1동","호프-간이주점",21,21,0,0,5,1,0
20242,"성수1가제2동","미곡판매",4,4,0,0,0,0,0
20242,"성수1가제2동","반찬가게",38,42,2,1,0,0,4
20242,"성수1가제2동","분식전문점",23,31,7,2,7,2,8
20242,"성수1가제2동","수산물판매",4,4,0,0,0,0,0
20242,"성수1가제2동","슈퍼마켓",17,25,12,3,0,0,8
20242,"성수1가제2동","양식음식점",101,104,7,7,8,8,3
20242,"성수1가제2동","육류판매",10,10,0,0,10,1,0
20242,"성수1가제2동","일식음식점",44,49,2,1,0,0,5
20242,"성수1가제2동","제과점",48,49,6,3,10,5,1
20242,"성수1가제2동","중식음식점",19,20,5,1,0,0,1
20242,"성수1가제2동","청과상",4,4,0,0,0,0,0
20242,"성수1가제2동","치킨전문점",4,12,0,0,0,0,8
20242,"성수1가제2동","커피-음료",194,220,4,8,6,14,26
20242,"성수1가제2동","패스트푸드점",24,30,10,3,7,2,6
20242,"성수1가제2동","한식음식점",178,195,10,19,5,9,17
20242,"성수1가제2동","호프-간이주점",51,62,0,0,5,3,11
20242,"성수2가제1동","미곡판매",9,9,0,0,0,0,0
20242,"성수2가제1동","반찬가게",31,31,0,0,0,0,0
20242,"성수2가제1동","분식전문점",29,34,6,2,6,2,5
20242,"성수2가제1동","수산물판매",10,10,0,0,0,0,0
20242,"성수2가제1동","슈퍼마켓",17,21,0,0,0,0,4
20242,"성수2가제1동","양식음식점",55,58,3,2,5,3,3
20242,"성수2가제1동","육류판매",10,10,10,1,0,0,0
20242,"성수2가제1동","일식음식점",22,23,17,4,9,2,1
20242,"성수2가제1동","제과점",28,30,3,1,3,1,2
20242,"성수2가제1동","중식음식점",10,11,9,1,9,1,1
20242,"성수2가제1동","청과상",16,16,0,0,0,0,0
20242,"성수2가제1동","치킨전문점",8,14,0,0,0,0,6
20242,"성수2가제1동","커피-음료",98,112,9,10,3,3,14
20242,"성수2가제1동","패스트푸드점",21,24,0,0,0,0,3
20242,"성수2가제1동","한식음식점",144,157,3,4,4,6,13
20242,"성수2가제1동","호프-간이주점",54,59,0,0,5,3,5
20242,"성수2가제3동","미곡판매",5,5,0,0,0,0,0
20242,"성수2가제3동","반찬가게",75,77,1,1,3,2,2
20242,"성수2가제3동","분식전문점",25,31,3,1,3,1,6
20242,"성수2가제3동","수산물판매",2,2,0,0,0,0,0
20242,"성수2가제3동","슈퍼마켓",28,44,9,4,0,0,16
20242,"성수2가제3동","양식음식점",66,70,4,3,0,0,4
20242,"성수2가제3동","육류판매",18,18,0,0,0,0,0
20242,"성수2가제3동","일식음식점",54,62,8,5,5,3,8
20242,"성수2가제3동","제과점",34,42,7,3,0,0,8
20242,"성수2가제3동","중식음식점",23,30,3,1,3,1,7
20242,"성수2가제3동","청과상",13,13,0,0,0,0,0
20242,"성수2가제3동","치킨전문점",4,11,0,0,0,0,7
20242,"성수2가제3동","커피-음료",167,204,4,9,2,3,37
20242,"성수2가제3동","패스트푸드점",24,38,3,1,3,1,14
20242,"성수2가제3동","한식음식점",259,294,4,11,4,13,35
20242,"성수2가제3동","호프-간이주점",55,66,2,1,5,3,11
20242,"송정동","미곡판매",2,2,0,0,0,0,0
20242,"송정동","반찬가게",2,2,0,0,0,0,0
20242,"송정동","분식전문점",6,6,0,0,0,0,0
20242,"송정동","수산물판매",2,2,0,0,0,0,0
20242,"송정동","슈퍼마켓",9,11,0,0,9,1,2
20242,"송정동","양식음식점",8,8,25,2,0,0,0
20242,"송정동","육류판매",6,6,0,0,0,0,0
20242,"송정동","일식음식점",2,2,0,0,0,0,0
20242,"송정동","제과점",6,6,0,0,0,0,0
20242,"송정동","중식음식점",2,2,0,0,0,0,0
20242,"송정동","청과상",4,4,0,0,0,0,0
20242,"송정동","치킨전문점",3,4,0,0,0,0,1
20242,"송정동","커피-음료",22,24,8,2,4,1,2
20242,"송정동","패스트푸드점",3,4,0,0,0,0,1
20242,"송정동","한식음식점",41,43,5,2,0,0,2
20242,"송정동","호프-간이주점",5,5,0,0,0,0,0
20242,"옥수동","미곡판매",2,2,0,0,0,0,0
20242,"옥수동","반찬가게",11,13,0,0,0,0,2
20242,"옥수동","분식전문점",11,16,6,1,6,1,5
20242,"옥수동","수산물판매",3,3,0,0,0,0,0
20242,"옥수동","슈퍼마켓",9,16,0,0,0,0,7
20242,"옥수동","양식음식점",9,9,0,0,0,0,0
20242,"옥수동","육류판매",8,9,0,0,0,0,1
20242,"옥수동","일식음식점",7,8,0,0,0,0,1
20242,"옥수동","제과점",11,15,0,0,0,0,4
20242,"옥수동","중식음식점",7,8,0,0,0,0,1
20242,"옥수동","청과상",4,4,0,0,0,0,0
20242,"옥수동","치킨전문점",3,9,0,0,0,0,6
20242,"옥수동","커피-음료",21,27,7,2,0,0,6
20242,"옥수동","패스트푸드점",9,12,8,1,8,1,3
20242,"옥수동","한식음식점",59,64,3,2,0,0,5
20242,"옥수동","호프-간이주점",8,9,0,0,0,0,1
20242,"왕십리도선동","미곡판매",8,8,0,0,13,1,0
20242,"왕십리도선동","반찬가게",27,29,3,1,0,0,2
20242,"왕십리도선동","분식전문점",44,61,3,2,7,4,17
20242,"왕십리도선동","수산물판매",7,7,0,0,14,1,0
20242,"왕십리도선동","슈퍼마켓",24,33,3,1,0,0,9
20242,"왕십리도선동","양식음식점",21,24,0,0,4,1,3
20242,"왕십리도선동","육류판매",54,54,0,0,2,1,0
20242,"왕십리도선동","일식음식점",16,19,0,0,11,2,3
20242,"왕십리도선동","제과점",18,24,4,1,8,2,6
20242,"왕십리도선동","중식음식점",15,18,0,0,0,0,3
20242,"왕십리도선동","청과상",17,17,0,0,6,1,0
20242,"왕십리도선동","치킨전문점",5,22,0,0,0,0,17
20242,"왕십리도선동","커피-음료",46,74,8,6,7,5,28
20242,"왕십리도선동","패스트푸드점",8,22,5,1,14,3,14
20242,"왕십리도선동","한식음식점",186,224,4,8,5,11,38
20242,"왕십리도선동","호프-간이주점",50,53,6,3,0,0,3
20242,"왕십리제2동","미곡판매",3,3,0,0,0,0,0
20242,"왕십리제2동","반찬가게",3,3,0,0,0,0,0
20242,"왕십리제2동","분식전문점",12,15,0,0,0,0,3
20242,"왕십리제2동","수산물판매",2,2,0,0,0,0,0
20242,"왕십리제2동","슈퍼마켓",10,15,0,0,0,0,5
20242,"왕십리제2동","양식음식점",5,8,0,0,0,0,3
20242,"왕십리제2동","육류판매",7,7,0,0,0,0,0
20242,"왕십리제2동","일식음식점",4,4,0,0,0,0,0
20242,"왕십리제2동","제과점",8,9,11,1,11,1,1
20242,"왕십리제2동","중식음식점",4,6,0,0,0,0,2
20242,"왕십리제2동","청과상",6,6,0,0,17,1,0
20242,"왕십리제2동","치킨전문점",7,12,0,0,0,0,5
20242,"왕십리제2동","커피-음료",22,25,0,0,0,0,3
20242,"왕십리제2동","패스트푸드점",5,14,7,1,0,0,9
20242,"왕십리제2동","한식음식점",45,48,2,1,4,2,3
20242,"왕십리제2동","호프-간이주점",6,7,0,0,0,0,1
20242,"용답동","미곡판매",4,4,0,0,0,0,0
20242,"용답동","반찬가게",8,9,11,1,22,2,1
20242,"용답동","분식전문점",15,22,14,3,5,1,7
20242,"용답동","수산물판매",5,5,0,0,0,0,0
20242,"용답동","슈퍼마켓",26,27,0,0,0,0,1
20242,"용답동","양식음식점",7,8,0,0,13,1,1
20242,"용답동","육류판매",22,22,0,0,0,0,0
20242,"용답동","일식음식점",8,8,13,1,25,2,0
20242,"용답동","제과점",3,4,0,0,25,1,1
20242,"용답동","중식음식점",7,7,0,0,14,1,0
20242,"용답동","청과상",11,11,9,1,0,0,0
20242,"용답동","치킨전문점",2,8,13,1,13,1,6
20242,"용답동","커피-음료",28,39,5,2,8,3,11
20242,"용답동","패스트푸드점",2,4,0,0,0,0,2
20242,"용답동","한식음식점",112,121,6,7,3,4,9
20242,"용답동","호프-간이주점",22,25,8,2,8,2,3
20242,"응봉동","미곡판매",2,2,0,0,0,0,0
20242,"응봉동","반찬가게",6,6,0,0,0,0,0
20242,"응봉동","분식전문점",5,5,0,0,0,0,0
20242,"응봉동","수산물판매",1,1,0,0,0,0,0
20242,"응봉동","슈퍼마켓",11,14,14,2,0,0,3
20242,"응봉동","양식음식점",3,3,0,0,0,0,0
20242,"응봉동","육류판매",4,4,0,0,0,0,0
20242,"응봉동","제과점",2,3,0,0,0,0,1
20242,"응봉동","중식음식점",1,1,0,0,0,0,0
20242,"응봉동","청과상",2,2,0,0,0,0,0
20242,"응봉동","치킨전문점",1,6,0,0,0,0,5
20242,"응봉동","커피-음료",7,9,11,1,11,1,2
20242,"응봉동","패스트푸드점",0,1,0,0,0,0,1
20242,"응봉동","한식음식점",9,9,0,0,0,0,0
20242,"응봉동","호프-간이주점",1,2,50,1,0,0,1
20242,"행당제1동","미곡판매",5,5,0,0,0,0,0
20242,"행당제1동","반찬가게",17,19,0,0,0,0,2
20242,"행당제1동","분식전문점",38,47,4,2,2,1,9
20242,"행당제1동","수산물판매",9,9,0,0,0,0,0
20242,"행당제1동","슈퍼마켓",15,21,5,1,0,0,6
20242,"행당제1동","양식음식점",22,29,0,0,10,3,7
20242,"행당제1동","육류판매",32,32,0,0,0,0,0
20242,"행당제1동","일식음식점",16,22,5,1,0,0,6
20242,"행당제1동","제과점",11,24,4,1,4,1,13
20242,"행당제1동","중식음식점",10,11,0,0,0,0,1
20242,"행당제1동","청과상",5,5,0,0,0,0,0
20242,"행당제1동","치킨전문점",4,16,0,0,19,3,12
20242,"행당제1동","커피-음료",36,54,7,4,6,3,18
20242,"행당제1동","패스트푸드점",7,17,0,0,6,1,10
20242,"행당제1동","한식음식점",113,138,4,6,4,6,25
20242,"행당제1동","호프-간이주점",18,19,5,1,0,0,1
20242,"행당제2동","미곡판매",1,1,0,0,0,0,0
20242,"행당제2동","반찬가게",10,11,0,0,0,0,1
20242,"행당제2동","분식전문점",6,13,0,0,0,0,7
20242,"행당제2동","수산물판매",2,2,0,0,50,1,0
20242,"행당제2동","슈퍼마켓",4,7,14,1,14,1,3
20242,"행당제2동","양식음식점",2,2,0,0,0,0,0
20242,"행당제2동","육류판매",4,4,0,0,0,0,0
20242,"행당제2동","일식음식점",2,2,0,0,0,0,0
20242,"행당제2동","제과점",5,10,0,0,0,0,5
20242,"행당제2동","중식음식점",1,3,0,0,0,0,2
20242,"행당제2동","청과상",7,7,0,0,0,0,0
20242,"행당제2동","치킨전문점",1,11,9,1,9,1,10
20242,"행당제2동","커피-음료",11,16,0,0,0,0,5
20242,"행당제2동","패스트푸드점",3,6,0,0,0,0,3
20242,"행당제2동","한식음식점",16,19,5,1,0,0,3
20242,"행당제2동","호프-간이주점",3,5,0,0,0,0,2
20243,"금호1가동","미곡판매",4,4,0,0,0,0,0
20243,"금호1가동","반찬가게",4,4,25,1,0,0,0
20243,"금호1가동","분식전문점",6,8,0,0,13,1,2
20243,"금호1가동","수산물판매",3,3,0,0,0,0,0
20243,"금호1가동","슈퍼마켓",9,11,0,0,9,1,2
20243,"금호1가동","양식음식점",6,6,0,0,0,0,0
20243,"금호1가동","육류판매",5,5,0,0,0,0,0
20243,"금호1가동","일식음식점",3,3,0,0,0,0,0
20243,"금호1가동","제과점",2,3,0,0,33,1,1
20243,"금호1가동","중식음식점",1,3,0,0,0,0,2
20243,"금호1가동","청과상",7,7,0,0,0,0,0
20243,"금호1가동","치킨전문점",2,5,0,0,20,1,3
20243,"금호1가동","커피-음료",15,19,11,2,0,0,4
20243,"금호1가동","패스트푸드점",2,6,0,0,0,0,4
20243,"금호1가동","한식음식점",23,28,7,2,4,1,5
20243,"금호1가동","호프-간이주점",7,7,0,0,14,1,0
20243,"금호2.3가동","미곡판매",3,3,0,0,0,0,0
20243,"금호2.3가동","반찬가게",11,12,0,0,8,1,1
20243,"금호2.3가동","분식전문점",20,24,4,1,0,0,4
20243,"금호2.3가동","수산물판매",5,5,0,0,0,0,0
20243,"금호2.3가동","슈퍼마켓",16,21,0,0,10,2,5
20243,"금호2.3가동","양식음식점",14,15,0,0,20,3,1
20243,"금호2.3가동","육류판매",14,14,7,1,14,2,0
20243,"금호2.3가동","일식음식점",7,8,13,1,0,0,1
20243,"금호2.3가동","제과점",7,10,0,0,0,0,3
20243,"금호2.3가동","중식음식점",5,6,0,0,0,0,1
20243,"금호2.3가동","청과상",5,5,0,0,0,0,0
20243,"금호2.3가동","치킨전문점",9,19,5,1,0,0,10
20243,"금호2.3가동","커피-음료",27,34,3,1,3,1,7
20243,"금호2.3가동","패스트푸드점",2,12,0,0,0,0,10
20243,"금호2.3가동","한식음식점",105,116,9,10,8,9,11
20243,"금호2.3가동","호프-간이주점",27,28,0,0,7,2,1
20243,"금호4가동","미곡판매",1,1,0,0,0,0,0
20243,"금호4가동","반찬가게",4,4,0,0,0,0,0
20243,"금호4가동","분식전문점",7,12,0,0,8,1,5
20243,"금호4가동","수산물판매",0,0,0,0,0,0,0
20243,"금호4가동","슈퍼마켓",8,10,10,1,0,0,2
20243,"금호4가동","양식음식점",4,4,0,0,0,0,0
20243,"금호4가동","육류판매",3,3,0,0,0,0,0
20243,"금호4가동","일식음식점",7,7,14,1,0,0,0
20243,"금호4가동","제과점",5,7,0,0,0,0,2
20243,"금호4가동","중식음식점",4,5,0,0,0,0,1
20243,"금호4가동","청과상",5,5,0,0,0,0,0
20243,"금호4가동","치킨전문점",1,6,0,0,17,1,5
20243,"금호4가동","커피-음료",15,23,0,0,0,0,8
20243,"금호4가동","패스트푸드점",4,9,11,1,0,0,5
20243,"금호4가동","한식음식점",46,49,4,2,6,3,3
20243,"금호4가동","호프-간이주점",20,20,0,0,0,0,0
20243,"마장동","미곡판매",2,2,0,0,0,0,0
20243,"마장동","반찬가게",16,16,6,1,6,1,0
20243,"마장동","분식전문점",10,13,0,0,0,0,3
20243,"마장동","수산물판매",2,2,0,0,0,0,0
20243,"마장동","슈퍼마켓",25,28,4,1,7,2,3
20243,"마장동","양식음식점",4,5,0,0,0,0,1
20243,"마장동","육류판매",1581,1581,1,16,2,27,0
20243,"마장동","일식음식점",3,3,0,0,67,2,0
20243,"마장동","제과점",3,5,20,1,0,0,2
20243,"마장동","중식음식점",5,5,0,0,0,0,0
20243,"마장동","청과상",37,37,19,7,0,0,0
20243,"마장동","치킨전문점",2,9,0,0,0,0,7
20243,"마장동","커피-음료",22,27,4,1,11,3,5
20243,"마장동","패스트푸드점",3,5,0,0,0,0,2
20243,"마장동","한식음식점",116,120,5,6,8,10,4
20243,"마장동","호프-간이주점",18,22,0,0,5,1,4
20243,"사근동","미곡판매",3,3,0,0,0,0,0
20243,"사근동","반찬가게",4,4,0,0,25,1,0
20243,"사근동","분식전문점",20,31,0,0,7,2,11
20243,"사근동","슈퍼마켓",14,17,0,0,0,0,3
20243,"사근동","양식음식점",21,24,0,0,8,2,3
20243,"사근동","육류판매",4,4,0,0,0,0,0
20243,"사근동","일식음식점",20,24,4,1,4,1,4
20243,"사근동","제과점",7,12,8,1,0,0,5
20243,"사근동","중식음식점",15,23,0,0,0,0,8
20243,"사근동","청과상",1,1,0,0,0,0,0
20243,"사근동","치킨전문점",8,18,0,0,6,1,10
20243,"사근동","커피-음료",62,88,2,2,2,2,26
20243,"사근동","패스트푸드점",11,26,0,0,0,0,15
20243,"사근동","한식음식점",117,146,3,5,5,7,29
20243,"사근동","호프-간이주점",50,63,3,2,10,6,13
20243,"성수1가제1동","미곡판매",3,3,0,0,0,0,0
20243,"성수1가제1동","반찬가게",12,12,0,0,0,0,0
20243,"성수1가제1동","분식전문점",18,19,5,1,11,2,1
20243,"성수1가제1동","수산물판매",1,1,0,0,0,0,0
20243,"성수1가제1동","슈퍼마켓",10,21,14,3,0,0,11
20243,"성수1가제1동","양식음식점",48,50,2,1,0,0,2
20243,"성수1가제1동","육류판매",5,5,0,0,0,0,0
20243,"성수1가제1동","일식음식점",15,16,0,0,0,0,1
20243,"성수1가제1동","제과점",21,22,5,1,0,0,1
20243,"성수1가제1동","중식음식점",11,13,0,0,0,0,2
20243,"성수1가제1동","청과상",5,5,20,1,0,0,0
20243,"성수1가제1동","치킨전문점",1,7,0,0,0,0,6
20243,"성수1가제1동","커피-음료",62,78,5,4,8,6,16
20243,"성수1가제1동","패스트푸드점",8,14,7,1,21,3,6
20243,"성수1가제1동","한식음식점",75,81,4,3,3,2,6
20243,"성수1가제1동","호프-간이주점",21,21,0,0,0,0,0
20243,"성수1가제2동","미곡판매",4,4,0,0,0,0,0
20243,"성수1가제2동","반찬가게",41,45,7,3,0,0,4
20243,"성수1가제2동","분식전문점",22,30,3,1,7,2,8
20243,"성수1가제2동","수산물판매",4,4,0,0,0,0,0
20243,"성수1가제2동","슈퍼마켓",16,25,4,1,4,1,9
20243,"성수1가제2동","양식음식점",100,103,3,3,4,4,3
20243,"성수1가제2동","육류판매",10,10,0,0,0,0,0
20243,"성수1가제2동","일식음식점",47,52,8,4,2,1,5
20243,"성수1가제2동","제과점",45,46,2,1,9,4,1
20243,"성수1가제2동","중식음식점",17,18,0,0,11,2,1
20243,"성수1가제2동","청과상",4,4,0,0,0,0,0
20243,"성수1가제2동","치킨전문점",4,12,0,0,0,0,8
20243,"성수1가제2동","커피-음료",198,224,5,10,3,6,26
20243,"성수1가제2동","패스트푸드점",23,29,0,0,3,1,6
20243,"성수1가제2동","한식음식점",179,194,4,8,5,9,15
20243,"성수1가제2동","호프-간이주점",47,58,3,2,10,6,11
20243,"성수2가제1동","미곡판매",9,9,0,0,0,0,0
20243,"성수2가제1동","반찬가게",32,32,3,1,0,0,0
20243,"성수2가제1동","분식전문점",30,35,11,4,9,3,5
20243,"성수2가제1동","수산물판매",10,10,0,0,0,0,0
20243,"성수2가제1동","슈퍼마켓",16,20,0,0,5,1,4
20243,"성수2가제1동","양식음식점",57,60,7,4,3,2,3
20243,"성수2가제1동","육류판매",10,10,0,0,0,0,0
20243,"성수2가제1동","일식음식점",23,24,4,1,0,0,1
20243,"성수2가제1동","제과점",27,29,0,0,3,1,2
20243,"성수2가제1동","중식음식점",10,11,0,0,0,0,1
20243,"성수2가제1동","청과상",16,16,0,0,0,0,0
20243,"성수2가제1동","치킨전문점",8,14,0,0,0,0,6
20243,"성수2가제1동","커피-음료",94,107,1,1,6,6,13
20243,"성수2가제1동","패스트푸드점",20,23,0,0,4,1,3
20243,"성수2가제1동","한식음식점",149,162,4,6,1,1,13
20243,"성수2가제1동","호프-간이주점",55,60,2,1,0,0,5
20243,"성수2가제3동","미곡판매",5,5,0,0,0,0,0
20243,"성수2가제3동","반찬가게",71,73,1,1,7,5,2
20243,"성수2가제3동","분식전문점",23,29,7,2,14,4,6
20243,"성수2가제3동","수산물판매",2,2,0,0,0,0,0
20243,"성수2가제3동","슈퍼마켓",30,44,5,2,5,2,14
20243,"성수2가제3동","양식음식점",66,70,1,1,1,1,4
20243,"성수2가제3동","육류판매",18,18,0,0,0,0,0
20243,"성수2가제3동","일식음식점",54,62,0,0,0,0,8
20243,"성수2가제3동","제과점",35,43,7,3,5,2,8
20243,"성수2가제3동","중식음식점",20,27,4,1,15,4,7
20243,"성수2가제3동","청과상",13,13,0,0,0,0,0
20243,"성수2가제3동","치킨전문점",4,10,0,0,10,1,6
20243,"성수2가제3동","커피-음료",168,205,5,10,4,9,37
20243,"성수2가제3동","패스트푸드점",24,38,0,0,0,0,14
20243,"성수2가제3동","한식음식점",263,298,4,13,3,9,35
20243,"성수2가제3동","호프-간이주점",53,62,0,0,7,4,9
20243,"송정동","미곡판매",2,2,0,0,0,0,0
20243,"송정동","반찬가게",2,2,0,0,0,0,0
20243,"송정동","분식전문점",6,6,0,0,0,0,0
20243,"송정동","수산물판매",2,2,0,0,0,0,0
20243,"송정동","슈퍼마켓",9,11,0,0,0,0,2
20243,"송정동","양식음식점",7,7,14,1,29,2,0
20243,"송정동","육류판매",6,6,0,0,0,0,0
20243,"송정동","일식음식점",2,2,0,0,0,0,0
20243,"송정동","제과점",6,6,17,1,17,1,0
20243,"송정동","중식음식점",2,2,0,0,0,0,0
20243,"송정동","청과상",3,3,0,0,33,1,0
20243,"송정동","치킨전문점",3,4,0,0,0,0,1
20243,"송정동","커피-음료",22,24,8,2,8,2,2
20243,"송정동","패스트푸드점",3,4,25,1,25,1,1
20243,"송정동","한식음식점",41,42,2,1,5,2,1
20243,"송정동","호프-간이주점",5,5,0,0,0,0,0
20243,"옥수동","미곡판매",2,2,0,0,0,0,0
20243,"옥수동","반찬가게",12,14,7,1,0,0,2
20243,"옥수동","분식전문점",11,16,6,1,6,1,5
20243,"옥수동","수산물판매",3,3,0,0,0,0,0
20243,"옥수동","슈퍼마켓",9,16,0,0,0,0,7
20243,"옥수동","양식음식점",9,9,0,0,0,0,0
20243,"옥수동","육류판매",8,9,0,0,0,0,1
20243,"옥수동","일식음식점",7,8,0,0,0,0,1
20243,"옥수동","제과점",10,14,0,0,7,1,4
20243,"옥수동","중식음식점",7,8,0,0,0,0,1
20243,"옥수동","청과상",4,4,0,0,0,0,0
20243,"옥수동","치킨전문점",3,9,0,0,0,0,6
20243,"옥수동","커피-음료",22,29,10,3,3,1,7
20243,"옥수동","패스트푸드점",9,12,0,0,0,0,3
20243,"옥수동","한식음식점",58,63,2,1,3,2,5
20243,"옥수동","호프-간이주점",9,10,20,2,10,1,1
20243,"왕십리도선동","미곡판매",7,7,0,0,14,1,0
20243,"왕십리도선동","반찬가게",26,28,0,0,4,1,2
20243,"왕십리도선동","분식전문점",44,59,3,2,7,4,15
20243,"왕십리도선동","수산물판매",7,7,0,0,0,0,0
20243,"왕십리도선동","슈퍼마켓",24,33,0,0,0,0,9
20243,"왕십리도선동","양식음식점",21,24,4,1,4,1,3
20243,"왕십리도선동","육류판매",48,48,2,1,15,7,0
20243,"왕십리도선동","일식음식점",17,19,11,2,11,2,2
20243,"왕십리도선동","제과점",18,24,4,1,4,1,6
20243,"왕십리도선동","중식음식점",15,18,6,1,6,1,3
20243,"왕십리도선동","청과상",18,18,6,1,0,0,0
20243,"왕십리도선동","치킨전문점",5,23,4,1,0,0,18
20243,"왕십리도선동","커피-음료",46,74,7,5,7,5,28
20243,"왕십리도선동","패스트푸드점",8,20,5,1,15,3,12
20243,"왕십리도선동","한식음식점",188,224,5,11,5,11,36
20243,"왕십리도선동","호프-간이주점",48,51,2,1,6,3,3
20243,"왕십리제2동","미곡판매",3,3,0,0,0,0,0
20243,"왕십리제2동","반찬가게",3,3,0,0,0,0,0
20243,"왕십리제2동","분식전문점",12,15,0,0,0,0,3
20243,"왕십리제2동","수산물판매",2,2,0,0,0,0,0
20243,"왕십리제2동","슈퍼마켓",10,15,0,0,0,0,5
20243,"왕십리제2동","양식음식점",5,8,0,0,0,0,3
20243,"왕십리제2동","육류판매",8,8,13,1,0,0,0
20243,"왕십리제2동","일식음식점",5,5,20,1,0,0,0
20243,"왕십리제2동","제과점",7,8,0,0,13,1,1
20243,"왕십리제2동","중식음식점",3,5,0,0,20,1,2
20243,"왕십리제2동","청과상",7,7,14,1,0,0,0
20243,"왕십리제2동","치킨전문점",6,11,0,0,9,1,5
20243,"왕십리제2동","커피-음료",22,25,4,1,4,1,3
20243,"왕십리제2동","패스트푸드점",4,11,0,0,27,3,7
20243,"왕십리제2동","한식음식점",48,51,10,5,4,2,3
20243,"왕십리제2동","호프-간이주점",6,7,0,0,0,0,1
20243,"용답동","미곡판매",4,4,0,0,0,0,0
20243,"용답동","반찬가게",8,9,11,1,11,1,1
20243,"용답동","분식전문점",14,21,0,0,5,1,7
20243,"용답동","수산물판매",5,5,0,0,0,0,0
20243,"용답동","슈퍼마켓",26,27,0,0,0,0,1
20243,"용답동","양식음식점",5,6,0,0,33,2,1
20243,"용답동","육류판매",22,22,0,0,0,0,0
20243,"용답동","일식음식점",9,9,11,1,0,0,0
20243,"용답동","제과점",3,4,0,0,0,0,1
20243,"용답동","중식음식점",8,8,13,1,0,0,0
20243,"용답동","청과상",11,11,9,1,9,1,0
20243,"용답동","치킨전문점",2,8,0,0,0,0,6
20243,"용답동","커피-음료",27,38,11,4,13,5,11
20243,"용답동","패스트푸드점",2,4,0,0,0,0,2
20243,"용답동","한식음식점",115,125,6,7,2,3,10
20243,"용답동","호프-간이주점",21,24,0,0,4,1,3
20243,"응봉동","미곡판매",2,2,0,0,0,0,0
20243,"응봉동","반찬가게",5,5,0,0,20,1,0
20243,"응봉동","분식전문점",5,5,0,0,0,0,0
20243,"응봉동","수산물판매",1,1,0,0,0,0,0
20243,"응봉동","슈퍼마켓",11,14,0,0,0,0,3
20243,"응봉동","양식음식점",3,3,0,0,0,0,0
20243,"응봉동","육류판매",4,4,0,0,0,0,0
20243,"응봉동","제과점",1,2,0,0,50,1,1
20243,"응봉동","중식음식점",1,1,0,0,0,0,0
20243,"응봉동","청과상",2,2,0,0,0,0,0
20243,"응봉동","치킨전문점",1,5,0,0,20,1,4
20243,"응봉동","커피-음료",6,8,0,0,13,1,2
20243,"응봉동","패스트푸드점",0,1,0,0,0,0,1
20243,"응봉동","한식음식점",8,8,13,1,25,2,0
20243,"응봉동","호프-간이주점",1,2,0,0,0,0,1
20243,"행당제1동","미곡판매",5,5,0,0,0,0,0
20243,"행당제1동","반찬가게",17,19,0,0,0,0,2
20243,"행당제1동","분식전문점",34,43,0,0,9,4,9
20243,"행당제1동","수산물판매",9,9,0,0,0,0,0
20243,"행당제1동","슈퍼마켓",17,23,17,4,9,2,6
20243,"행당제1동","양식음식점",22,29,0,0,0,0,7
20243,"행당제1동","육류판매",32,32,0,0,0,0,0
20243,"행당제1동","일식음식점",18,24,13,3,4,1,6
20243,"행당제1동","제과점",11,24,0,0,0,0,13
20243,"행당제1동","중식음식점",11,12,8,1,0,0,1
20243,"행당제1동","청과상",4,4,0,0,25,1,0
20243,"행당제1동","치킨전문점",4,16,0,0,0,0,12
20243,"행당제1동","커피-음료",33,50,0,0,8,4,17
20243,"행당제1동","패스트푸드점",8,18,6,1,0,0,10
20243,"행당제1동","한식음식점",113,136,2,3,4,5,23
20243,"행당제1동","호프-간이주점",18,19,0,0,0,0,1
20243,"행당제2동","미곡판매",1,1,0,0,0,0,0
20243,"행당제2동","반찬가게",10,11,0,0,0,0,1
20243,"행당제2동","분식전문점",6,11,0,0,18,2,5
20243,"행당제2동","수산물판매",2,2,0,0,0,0,0
20243,"행당제2동","슈퍼마켓",5,8,13,1,0,0,3
20243,"행당제2동","양식음식점",2,2,0,0,0,0,0
20243,"행당제2동","육류판매",4,4,0,0,0,0,0
20243,"행당제2동","일식음식점",2,2,0,0,0,0,0
20243,"행당제2동","제과점",5,10,0,0,0,0,5
20243,"행당제2동","중식음식점",1,3,0,0,0,0,2
20243,"행당제2동","청과상",8,8,13,1,0,0,0
20243,"행당제2동","치킨전문점",1,11,0,0,0,0,10
20243,"행당제2동","커피-음료",11,14,0,0,14,2,3
20243,"행당제2동","패스트푸드점",3,8,25,2,0,0,5
20243,"행당제2동","한식음식점",16,19,0,0,0,0,3
20243,"행당제2동","호프-간이주점",3,5,0,0,0,0,2
20244,"금호1가동","미곡판매",4,4,0,0,0,0,0
20244,"금호1가동","반찬가게",5,5,20,1,0,0,0
20244,"금호1가동","분식전문점",6,8,0,0,0,0,2
20244,"금호1가동","수산물판매",3,3,0,0,0,0,0
20244,"금호1가동","슈퍼마켓",9,11,0,0,0,0,2
20244,"금호1가동","양식음식점",6,6,0,0,0,0,0
20244,"금호1가동","육류판매",5,5,0,0,0,0,0
20244,"금호1가동","일식음식점",3,3,0,0,0,0,0
20244,"금호1가동","제과점",2,3,0,0,0,0,1
20244,"금호1가동","중식음식점",1,3,0,0,0,0,2
20244,"금호1가동","청과상",7,7,0,0,0,0,0
20244,"금호1가동","치킨전문점",2,5,0,0,0,0,3
20244,"금호1가동","커피-음료",14,18,0,0,6,1,4
20244,"금호1가동","패스트푸드점",2,6,0,0,0,0,4
20244,"금호1가동","한식음식점",23,28,0,0,0,0,5
20244,"금호1가동","호프-간이주점",7,7,14,1,14,1,0
20244,"금호2.3가동","미곡판매",3,3,0,0,0,0,0
20244,"금호2.3가동","반찬가게",11,12,0,0,0,0,1
20244,"금호2.3가동","분식전문점",20,24,4,1,4,1,4
20244,"금호2.3가동","수산물판매",5,5,0,0,0,0,0
20244,"금호2.3가동","슈퍼마켓",16,21,0,0,0,0,5
20244,"금호2.3가동","양식음식점",14,15,0,0,0,0,1
20244,"금호2.3가동","육류판매",14,14,0,0,0,0,0
20244,"금호2.3가동","일식음식점",7,7,0,0,14,1,0
20244,"금호2.3가동","제과점",7,10,0,0,0,0,3
20244,"금호2.3가동","중식음식점",6,7,14,1,0,0,1
20244,"금호2.3가동","청과상",7,7,29,2,0,0,0
20244,"금호2.3가동","치킨전문점",9,18,0,0,6,1,9
20244,"금호2.3가동","커피-음료",27,35,3,1,0,0,8
20244,"금호2.3가동","패스트푸드점",4,14,7,1,0,0,10
20244,"금호2.3가동","한식음식점",106,117,4,5,3,4,11
20244,"금호2.3가동","호프-간이주점",28,29,3,1,0,0,1
20244,"금호4가동","미곡판매",1,1,0,0,0,0,0
20244,"금호4가동","반찬가게",4,4,0,0,0,0,0
20244,"금호4가동","분식전문점",9,14,14,2,0,0,5
20244,"금호4가동","수산물판매",0,0,0,0,0,0,0
20244,"금호4가동","슈퍼마켓",8,12,25,3,8,1,4
20244,"금호4가동","양식음식점",5,5,20,1,0,0,0
20244,"금호4가동","육류판매",3,3,0,0,0,0,0
20244,"금호4가동","일식음식점",7,7,0,0,0,0,0
20244,"금호4가동","제과점",3,5,0,0,40,2,2
20244,"금호4가동","중식음식점",4,5,0,0,0,0,1
20244,"금호4가동","청과상",5,5,0,0,0,0,0
20244,"금호4가동","치킨전문점",1,6,0,0,0,0,5
20244,"금호4가동","커피-음료",15,23,0,0,0,0,8
20244,"금호4가동","패스트푸드점",3,7,0,0,29,2,4
20244,"금호4가동","한식음식점",48,52,10,5,4,2,4
20244,"금호4가동","호프-간이주점",20,20,0,0,0,0,0
20244,"마장동","미곡판매",2,2,0,0,0,0,0
20244,"마장동","반찬가게",17,17,6,1,0,0,0
20244,"마장동","분식전문점",10,13,0,0,0,0,3
20244,"마장동","수산물판매",2,2,0,0,0,0,0
20244,"마장동","슈퍼마켓",24,27,0,0,4,1,3
20244,"마장동","양식음식점",4,5,0,0,0,0,1
20244,"마장동","육류판매",1560,1560,0,5,2,26,0
20244,"마장동","일식음식점",3,3,33,1,33,1,0
20244,"마장동","제과점",3,5,0,0,0,0,2
20244,"마장동","중식음식점",5,5,0,0,0,0,0
20244,"마장동","청과상",39,39,5,2,0,0,0
20244,"마장동","치킨전문점",2,9,0,0,0,0,7
20244,"마장동","커피-음료",22,27,4,1,4,1,5
20244,"마장동","패스트푸드점",3,5,0,0,0,0,2
20244,"마장동","한식음식점",119,123,2,3,0,0,4
20244,"마장동","호프-간이주점",18,22,0,0,0,0,4
20244,"사근동","미곡판매",3,3,0,0,0,0,0
20244,"사근동","반찬가게",4,4,0,0,0,0,0
20244,"사근동","분식전문점",23,34,12,4,3,1,11
20244,"사근동","슈퍼마켓",14,17,0,0,0,0,3
20244,"사근동","양식음식점",23,26,8,2,0,0,3
20244,"사근동","육류판매",4,4,0,0,0,0,0
20244,"사근동","일식음식점",19,23,0,0,4,1,4
20244,"사근동","제과점",7,12,0,0,0,0,5
20244,"사근동","중식음식점",15,23,9,2,9,2,8
20244,"사근동","청과상",1,1,0,0,0,0,0
20244,"사근동","치킨전문점",7,17,0,0,6,1,10
20244,"사근동","커피-음료",59,84,0,0,5,4,25
20244,"사근동","패스트푸드점",10,25,0,0,4,1,15
20244,"사근동","한식음식점",119,147,2,3,1,2,28
20244,"사근동","호프-간이주점",47,60,3,2,8,5,13
20244,"성수1가제1동","미곡판매",3,3,0,0,0,0,0
20244,"성수1가제1동","반찬가게",11,11,0,0,0,0,0
20244,"성수1가제1동","분식전문점",17,19,11,2,11,2,2
20244,"성수1가제1동","수산물판매",1,1,0,0,0,0,0
20244,"성수1가제1동","슈퍼마켓",11,21,5,1,5,1,10
20244,"성수1가제1동","양식음식점",48,50,2,1,2,1,2
20244,"성수1가제1동","육류판매",5,5,0,0,0,0,0
20244,"성수1가제1동","일식음식점",16,17,6,1,0,0,1
20244,"성수1가제1동","제과점",21,22,0,0,0,0,1
20244,"성수1가제1동","중식음식점",10,12,0,0,8,1,2
20244,"성수1가제1동","청과상",6,6,17,1,0,0,0
20244,"성수1가제1동","치킨전문점",1,7,0,0,0,0,6
20244,"성수1가제1동","커피-음료",62,76,4,3,7,5,14
20244,"성수1가제1동","패스트푸드점",8,14,0,0,0,0,6
20244,"성수1가제1동","한식음식점",78,84,6,5,2,2,6
20244,"성수1가제1동","호프-간이주점",21,21,0,0,0,0,0
20244,"성수1가제2동","미곡판매",4,4,0,0,0,0,0
20244,"성수1가제2동","반찬가게",42,46,2,1,0,0,4
20244,"성수1가제2동","분식전문점",22,30,0,0,0,0,8
20244,"성수1가제2동","수산물판매",4,4,0,0,0,0,0
20244,"성수1가제2동","슈퍼마켓",19,28,11,3,0,0,9
20244,"성수1가제2동","양식음식점",99,102,6,6,7,7,3
20244,"성수1가제2동","육류판매",9,9,0,0,11,1,0
20244,"성수1가제2동","일식음식점",51,56,9,5,2,1,5
20244,"성수1가제2동","제과점",46,47,2,1,0,0,1
20244,"성수1가제2동","중식음식점",14,15,7,1,27,4,1
20244,"성수1가제2동","청과상",5,6,33,2,0,0,1
20244,"성수1가제2동","치킨전문점",4,11,0,0,9,1,7
20244,"성수1가제2동","커피-음료",197,222,4,8,5,10,25
20244,"성수1가제2동","패스트푸드점",23,29,0,0,0,0,6
20244,"성수1가제2동","한식음식점",190,206,7,14,1,2,16
20244,"성수1가제2동","호프-간이주점",42,53,0,0,9,5,11
20244,"성수2가제1동","미곡판매",9,9,0,0,0,0,0
20244,"성수2가제1동","반찬가게",31,31,0,0,3,1,0
20244,"성수2가제1동","분식전문점",30,34,0,0,3,1,4
20244,"성수2가제1동","수산물판매",10,10,0,0,0,0,0
20244,"성수2가제1동","슈퍼마켓",17,21,5,1,0,0,4
20244,"성수2가제1동","양식음식점",58,61,5,3,3,2,3
20244,"성수2가제1동","육류판매",10,10,0,0,0,0,0
20244,"성수2가제1동","일식음식점",20,21,0,0,14,3,1
20244,"성수2가제1동","제과점",29,31,7,2,0,0,2
20244,"성수2가제1동","중식음식점",11,12,8,1,0,0,1
20244,"성수2가제1동","청과상",16,16,0,0,0,0,0
20244,"성수2가제1동","치킨전문점",8,14,0,0,0,0,6
20244,"성수2가제1동","커피-음료",92,105,2,2,4,4,13
20244,"성수2가제1동","패스트푸드점",20,22,0,0,5,1,2
20244,"성수2가제1동","한식음식점",150,163,3,5,3,4,13
20244,"성수2가제1동","호프-간이주점",54,59,2,1,3,2,5
20244,"성수2가제3동","미곡판매",5,5,0,0,0,0,0
20244,"성수2가제3동","반찬가게",70,72,0,0,1,1,2
20244,"성수2가제3동","분식전문점",24,29,14,4,14,4,5
20244,"성수2가제3동","수산물판매",2,2,0,0,0,0,0
20244,"성수2가제3동","슈퍼마켓",35,49,12,6,2,1,14
20244,"성수2가제3동","양식음식점",62,66,2,1,8,5,4
20244,"성수2가제3동","육류판매",18,18,0,0,0,0,0
20244,"성수2가제3동","일식음식점",54,62,5,3,5,3,8
20244,"성수2가제3동","제과점",37,45,7,3,2,1,8
20244,"성수2가제3동","중식음식점",20,26,4,1,8,2,6
20244,"성수2가제3동","청과상",12,12,0,0,8,1,0
20244,"성수2가제3동","치킨전문점",2,9,11,1,22,2,7
20244,"성수2가제3동","커피-음료",169,206,4,8,4,8,37
20244,"성수2가제3동","패스트푸드점",20,34,0,0,12,4,14
20244,"성수2가제3동","한식음식점",265,299,3,9,3,8,34
20244,"성수2가제3동","호프-간이주점",50,56,2,1,13,7,6
20244,"송정동","미곡판매",2,2,0,0,0,0,0
20244,"송정동","반찬가게",2,2,0,0,0,0,0
20244,"송정동","분식전문점",6,6,0,0,0,0,0
20244,"송정동","수산물판매",2,2,0,0,0,0,0
20244,"송정동","슈퍼마켓",9,11,0,0,0,0,2
20244,"송정동","양식음식점",7,7,0,0,0,0,0
20244,"송정동","육류판매",6,6,0,0,0,0,0
20244,"송정동","일식음식점",2,2,0,0,0,0,0
20244,"송정동","제과점",8,8,25,2,0,0,0
20244,"송정동","중식음식점",2,2,0,0,0,0,0
20244,"송정동","청과상",3,3,0,0,0,0,0
20244,"송정동","치킨전문점",3,4,0,0,0,0,1
20244,"송정동","커피-음료",25,27,15,4,4,1,2
20244,"송정동","패스트푸드점",3,4,0,0,0,0,1
20244,"송정동","한식음식점",36,37,3,1,16,6,1
20244,"송정동","호프-간이주점",5,5,20,1,20,1,0
20244,"옥수동","미곡판매",2,2,0,0,0,0,0
20244,"옥수동","반찬가게",12,14,7,1,7,1,2
20244,"옥수동","분식전문점",11,16,0,0,0,0,5
20244,"옥수동","수산물판매",3,3,0,0,0,0,0
20244,"옥수동","슈퍼마켓",9,16,0,0,0,0,7
20244,"옥수동","양식음식점",9,9,0,0,0,0,0
20244,"옥수동","육류판매",8,9,0,0,0,0,1
20244,"옥수동","일식음식점",6,7,0,0,14,1,1
20244,"옥수동","제과점",9,14,7,1,7,1,5
20244,"옥수동","중식음식점",6,7,0,0,14,1,1
20244,"옥수동","청과상",4,4,0,0,0,0,0
20244,"옥수동","치킨전문점",3,9,0,0,0,0,6
20244,"옥수동","커피-음료",22,29,0,0,0,0,7
20244,"옥수동","패스트푸드점",8,11,0,0,9,1,3
20244,"옥수동","한식음식점",59,64,3,2,2,1,5
20244,"옥수동","호프-간이주점",8,9,0,0,11,1,1
20244,"왕십리도선동","미곡판매",7,7,0,0,0,0,0
20244,"왕십리도선동","반찬가게",26,28,0,0,0,0,2
20244,"왕십리도선동","분식전문점",44,57,2,1,5,3,13
20244,"왕십리도선동","수산물판매",7,7,0,0,0,0,0
20244,"왕십리도선동","슈퍼마켓",24,33,0,0,0,0,9
20244,"왕십리도선동","양식음식점",18,21,0,0,14,3,3
20244,"왕십리도선동","육류판매",47,47,2,1,4,2,0
20244,"왕십리도선동","일식음식점",18,20,5,1,0,0,2
20244,"왕십리도선동","제과점",19,25,4,1,0,0,6
20244,"왕십리도선동","중식음식점",14,17,0,0,6,1,3
20244,"왕십리도선동","청과상",17,17,0,0,6,1,0
20244,"왕십리도선동","치킨전문점",5,24,4,1,0,0,19
20244,"왕십리도선동","커피-음료",46,72,3,2,6,4,26
20244,"왕십리도선동","패스트푸드점",7,18,6,1,17,3,11
20244,"왕십리도선동","한식음식점",190,226,3,6,2,4,36
20244,"왕십리도선동","호프-간이주점",49,52,2,1,0,0,3
20244,"왕십리제2동","미곡판매",3,3,0,0,0,0,0
20244,"왕십리제2동","반찬가게",4,4,0,0,0,0,0
20244,"왕십리제2동","분식전문점",10,12,0,0,25,3,2
20244,"왕십리제2동","수산물판매",2,2,0,0,0,0,0
20244,"왕십리제2동","슈퍼마켓",10,16,13,2,6,1,6
20244,"왕십리제2동","양식음식점",5,7,0,0,14,1,2
20244,"왕십리제2동","육류판매",8,8,0,0,0,0,0
20244,"왕십리제2동","일식음식점",5,5,0,0,0,0,0
20244,"왕십리제2동","제과점",8,9,11,1,0,0,1
20244,"왕십리제2동","중식음식점",3,5,0,0,0,0,2
20244,"왕십리제2동","청과상",6,6,0,0,17,1,0
20244,"왕십리제2동","치킨전문점",6,11,0,0,0,0,5
20244,"왕십리제2동","커피-음료",20,23,0,0,9,2,3
20244,"왕십리제2동","패스트푸드점",3,10,0,0,10,1,7
20244,"왕십리제2동","한식음식점",51,54,9,5,4,2,3
20244,"왕십리제2동","호프-간이주점",6,7,0,0,0,0,1
20244,"용답동","미곡판매",4,4,0,0,0,0,0
20244,"용답동","반찬가게",8,9,0,0,0,0,1
20244,"용답동","분식전문점",12,19,0,0,11,2,7
20244,"용답동","수산물판매",5,5,0,0,0,0,0
20244,"용답동","슈퍼마켓",24,25,0,0,8,2,1
20244,"용답동","양식음식점",5,6,0,0,0,0,1
20244,"용답동","육류판매",21,21,0,0,5,1,0
20244,"용답동","일식음식점",8,8,0,0,13,1,0
20244,"용답동","제과점",3,4,0,0,0,0,1
20244,"용답동","중식음식점",8,8,0,0,0,0,0
20244,"용답동","청과상",12,12,8,1,0,0,0
20244,"용답동","치킨전문점",2,8,0,0,0,0,6
20244,"용답동","커피-음료",27,39,5,2,3,1,12
20244,"용답동","패스트푸드점",2,4,0,0,0,0,2
20244,"용답동","한식음식점",116,126,3,4,2,3,10
20244,"용답동","호프-간이주점",21,24,0,0,0,0,3
20244,"응봉동","미곡판매",2,2,0,0,0,0,0
20244,"응봉동","반찬가게",5,5,0,0,0,0,0
20244,"응봉동","분식전문점",5,5,0,0,0,0,0
20244,"응봉동","수산물판매",1,1,0,0,0,0,0
20244,"응봉동","슈퍼마켓",11,14,0,0,0,0,3
20244,"응봉동","양식음식점",3,3,0,0,0,0,0
20244,"응봉동","육류판매",4,4,0,0,0,0,0
20244,"응봉동","제과점",1,2,0,0,0,0,1
20244,"응봉동","중식음식점",1,1,0,0,0,0,0
20244,"응봉동","청과상",2,2,0,0,0,0,0
20244,"응봉동","치킨전문점",1,5,0,0,0,0,4
20244,"응봉동","커피-음료",6,8,0,0,0,0,2
20244,"응봉동","패스트푸드점",0,1,0,0,0,0,1
20244,"응봉동","한식음식점",8,8,0,0,0,0,0
20244,"응봉동","호프-간이주점",1,2,0,0,0,0,1
20244,"행당제1동","미곡판매",5,5,0,0,0,0,0
20244,"행당제1동","반찬가게",18,20,5,1,0,0,2
20244,"행당제1동","분식전문점",34,43,2,1,2,1,9
20244,"행당제1동","수산물판매",9,9,0,0,0,0,0
20244,"행당제1동","슈퍼마켓",19,25,8,2,0,0,6
20244,"행당제1동","양식음식점",18,25,0,0,16,4,7
20244,"행당제1동","육류판매",32,32,0,0,0,0,0
20244,"행당제1동","일식음식점",17,23,4,1,9,2,6
20244,"행당제1동","제과점",11,23,0,0,4,1,12
20244,"행당제1동","중식음식점",12,13,8,1,0,0,1
20244,"행당제1동","청과상",4,4,0,0,0,0,0
20244,"행당제1동","치킨전문점",4,16,6,1,6,1,12
20244,"행당제1동","커피-음료",32,51,8,4,6,3,19
20244,"행당제1동","패스트푸드점",10,20,10,2,0,0,10
20244,"행당제1동","한식음식점",118,141,7,10,4,5,23
20244,"행당제1동","호프-간이주점",17,18,0,0,6,1,1
20244,"행당제2동","미곡판매",1,1,0,0,0,0,0
20244,"행당제2동","반찬가게",12,13,15,2,0,0,1
20244,"행당제2동","분식전문점",6,11,0,0,0,0,5
20244,"행당제2동","수산물판매",2,2,0,0,0,0,0
20244,"행당제2동","슈퍼마켓",5,8,0,0,0,0,3
20244,"행당제2동","양식음식점",2,2,0,0,0,0,0
20244,"행당제2동","육류판매",4,4,0,0,0,0,0
20244,"행당제2동","일식음식점",2,2,0,0,0,0,0
20244,"행당제2동","제과점",5,10,0,0,0,0,5
20244,"행당제2동","중식음식점",1,3,0,0,0,0,2
20244,"행당제2동","청과상",7,7,0,0,14,1,0
20244,"행당제2동","치킨전문점",1,11,0,0,0,0,10
20244,"행당제2동","커피-음료",11,14,0,0,0,0,3
20244,"행당제2동","패스트푸드점",3,7,0,0,14,1,4
20244,"행당제2동","한식음식점",16,19,0,0,0,0,3
20244,"행당제2동","호프-간이주점",3,5,0,0,0,0,2
